TRL_NUMBER,TRL_STOP_SIGNAL_DELAY,TRL_TARG_SSD_VRT_RFRSH_COUNT,TRL_TARG_ON_TIME,TRL_STOP_SIGNAL_TIME,TRL_STOP_SIGNAL_DURATION,TRL_FIX_ON_TIME,TRL_FIX_ACQ_TIME,TRL_FIX_HOLD_TIME,TRL_FIXATED_TIME
1,10,10,2532,2682,167,1067,1859,667,2526
2,48,48,8459,9242,799,7876,7890,561,8451
3,10,10,15435,15585,166,13920,14704,725,15429
4,50,50,22461,23276,832,20729,21518,936,22454
5,48,48,28904,29686,799,27538,28332,565,28897
6,46,46,35846,36595,766,34348,35146,694,35840
7,34,34,42522,43072,566,41174,41960,556,42516
8,24,24,49365,49748,399,47983,48774,584,49358
9,38,38,56224,56840,633,54792,55588,629,56217
10,56,56,63183,64099,932,61618,62402,775,63177
11,10,10,70109,70259,166,68427,69216,886,70102
12,42,42,76652,77334,699,75237,76030,616,76646
13,52,52,83578,84427,865,82046,82844,727,83571
14,14,14,90337,90553,233,88872,89658,673,90331
15,48,48,97396,98179,799,95681,96472,918,97390
16,10,10,104072,104222,167,102491,103286,780,104066
17,14,14,110648,110865,233,109316,110100,541,110641
18,48,48,117424,118207,799,116126,116914,504,117418
19,20,20,124250,124567,333,122935,123728,516,124244
20,58,58,130477,131426,965,129744,129759,710,130469
21,54,54,137103,137985,899,135788,136573,524,137097
22,42,42,144079,144761,699,142597,143387,685,144072
23,16,16,151188,151437,266,149406,150201,980,151181
24,28,28,157548,157997,466,156232,157015,526,157541
25,34,34,164623,165173,566,163042,163829,788,164617
26,46,46,171183,171932,766,169851,170643,533,171176
27,36,36,178092,178675,599,176660,177457,628,178085
28,60,60,184868,185850,999,183486,184271,590,184861
29,40,40,191727,192376,666,190295,191085,635,191720
30,12,12,198836,199019,200,197105,197899,931,198830
31,48,48,205296,206078,799,203931,204713,577,205290
32,6,6,212205,212288,100,210740,211527,672,212199
33,20,20,219097,219414,333,217549,218341,750,219091
34,52,52,225774,226623,865,224358,225155,612,225767
35,10,10,232616,232766,167,231184,231969,640,232609
36,16,16,239359,239609,266,237994,238783,570,239353
37,4,4,246418,246468,66,244803,245597,815,246412
38,46,46,253310,254060,766,251612,252411,893,253304
39,8,8,260070,260186,133,258438,259225,838,260063
40,10,10,266912,267062,167,265247,266039,867,266906
41,46,46,273439,274188,765,272057,272853,579,273432
42,46,46,280564,281313,766,278883,279667,891,280558
43,10,10,287124,287274,166,285692,286481,636,287117
44,18,18,294266,294549,300,292501,293295,965,294260
45,58,58,300609,301558,966,299311,300109,494,300603
46,10,10,307818,307968,166,306136,306923,888,307811
47,32,32,314261,314777,533,312946,313737,518,314255
48,8,8,321503,321620,133,319755,320551,946,321497
49,32,32,328013,328529,533,326581,327365,641,328006
50,30,30,334789,335272,499,333390,334179,603,334782
51,58,58,341914,342863,966,340200,340993,916,341909
52,50,50,348457,349273,833,347009,347807,644,348451
53,32,32,355583,356099,533,353835,354621,956,355577
54,50,50,361976,362792,832,360644,361435,534,361969
55,6,6,368885,368968,100,367453,368249,629,368878
56,38,38,375644,376260,633,374279,375063,575,375638
57,32,32,382787,383303,532,381089,381877,904,382781
58,12,12,388863,389047,200,387898,387908,949,388857
59,26,26,395240,395656,433,393925,394722,512,395234
60,46,46,402232,402981,766,400751,401536,690,402226
61,54,54,409042,409924,899,407560,408350,685,409035
62,28,28,415734,416184,466,414369,415164,564,415728
63,54,54,422743,423626,899,421195,421978,759,422737
64,34,34,429669,430219,566,428004,428792,871,429663
65,36,36,436245,436828,600,434814,435606,633,436239
66,22,22,443388,443737,366,441623,442420,962,443382
67,16,16,450080,450330,267,448449,449234,840,450074
68,30,30,456956,457439,500,455258,456048,902,456950
69,36,36,463533,464115,599,462067,462862,664,463526
70,56,56,470575,471491,932,468893,469676,892,470568
71,10,10,477351,477501,166,475703,476490,855,477345
72,32,32,484044,484560,532,482512,483304,733,484037
73,18,18,490903,491186,300,489321,490118,778,490896
74,36,36,497679,498262,599,496147,496932,740,497672
75,16,16,504671,504921,267,502956,503746,919,504665
76,24,24,511447,511830,400,509766,510560,881,511441
77,14,14,518273,518490,233,516575,517374,893,518267
78,6,6,524050,524133,100,523401,523405,638,524043
79,28,28,531093,531542,466,529428,530219,868,531087
80,60,60,537636,538618,998,536237,537033,596,537629
81,18,18,544511,544794,300,543063,543847,658,544505
82,36,36,551404,551987,599,549872,550661,736,551397
83,60,60,558463,559445,999,556682,557475,982,558457
84,58,58,565206,566155,965,563491,564289,911,565200
85,52,52,571865,572714,866,570317,571103,756,571859
86,36,36,578541,579124,600,577126,577917,618,578535
87,10,10,585567,585717,166,583935,584731,829,585560
88,2,2,592293,592310,33,590761,591545,741,592286
89,52,52,599219,600068,866,597571,598359,854,599213
90,12,12,606061,606244,200,604380,605173,882,606055
91,54,54,612787,613670,899,611189,611987,794,612781
92,12,12,619497,619680,200,618015,618801,689,619490
93,46,46,626156,626905,766,624824,625615,534,626149
94,18,18,633115,633398,300,631634,632429,680,633109
95,46,46,639841,640591,766,638460,639243,592,639835
96,38,38,646850,647466,633,645269,646057,787,646844
97,44,44,653643,654359,733,652078,652871,766,653637
98,58,58,660186,661135,966,658887,659685,494,660179
99,14,14,667245,667461,233,665713,666499,739,667238
100,22,22,674054,674404,367,672523,673313,735,674048
101,48,48,680914,681696,799,679332,680127,780,680907
102,4,4,687756,687806,67,686158,686941,809,687750
103,8,8,694615,694732,134,692967,693755,854,694609
104,36,36,701125,701708,599,699776,700569,549,701118
105,2,2,708301,708317,33,706586,707383,912,708295
106,20,20,714860,715176,333,713412,714197,657,714854
107,4,4,720854,720904,66,720221,720228,618,720846
108,56,56,727546,728462,933,726248,727042,498,727540
109,16,16,734522,734772,266,733057,733856,660,734516
110,2,2,741448,741465,33,739883,740670,772,741442
111,18,18,748307,748590,300,746692,747484,817,748301
112,32,32,754983,755499,533,753502,754298,679,754977
113,6,6,761876,761959,100,760327,761112,757,761869
114,40,40,768901,769551,666,767137,767926,970,768896
115,42,42,775661,776343,699,773946,774740,915,775655
116,42,42,782187,782870,699,780755,781554,626,782180
117,48,48,789030,789812,799,787581,788368,655,789023
118,20,20,795939,796255,333,794391,795182,751,795933
119,42,42,802865,803547,699,801200,801996,863,802859
120,34,34,809591,810140,566,808026,808810,775,809585
121,18,18,816600,816883,299,814835,815624,970,816594
122,8,8,823043,823159,133,821644,822438,598,823036
123,16,16,830002,830252,266,828454,829252,744,829996
124,52,52,837011,837860,866,835280,836066,939,837005
125,36,36,843404,843987,599,842089,842880,518,843398
126,14,14,850396,850613,234,848898,849694,696,850390
127,34,34,857172,857722,567,855724,856508,658,857166
128,60,60,863932,864914,999,862533,863322,603,863925
129,18,18,870758,871041,299,869343,870136,616,870752
130,12,12,877850,878033,200,876152,876950,894,877844
131,28,28,884743,885192,466,882978,883764,973,884737
132,38,38,891369,891985,632,889787,890578,784,891362
133,58,58,898012,898961,965,896596,897392,613,898005
134,54,54,905004,905886,899,903422,904206,791,904997
135,38,38,911813,912429,633,910232,911020,787,911807
136,8,8,918573,918689,133,917041,917834,732,918566
137,38,38,925382,925998,633,923850,924648,727,925375
138,26,26,932291,932707,433,930676,931462,823,932285
139,58,58,938834,939783,966,937485,938276,551,938827
140,18,18,945810,946093,299,944295,945090,714,945804
141,40,40,952869,953518,666,951121,951904,959,952863
142,34,34,959645,960194,566,957930,958718,921,959639
143,12,12,966154,966337,200,964739,965532,616,966148
144,4,4,972980,973030,67,971548,972346,627,972973
145,6,6,979923,980006,100,978374,979160,756,979916
146,30,30,986599,987082,499,985184,985974,619,986593
147,60,60,993458,994440,999,991993,992788,664,993452
148,48,48,1000367,1001150,799,998819,999602,759,1000361
149,2,2,1007343,1007360,33,1005628,1006416,921,1007337
150,38,38,1014219,1014835,633,1012438,1013230,983,1014213
151,28,28,1020562,1021012,466,1019247,1020044,512,1020556
152,4,4,1027621,1027671,67,1026073,1026858,757,1027615
153,6,6,1034497,1034580,100,1032882,1033672,819,1034491
154,18,18,1041290,1041573,299,1039691,1040486,797,1041283
155,26,26,1048265,1048682,433,1046517,1047300,959,1048259
156,10,10,1054658,1054808,167,1053327,1054114,538,1054652
157,42,42,1061867,1062550,700,1060136,1060928,933,1061861
158,54,54,1068460,1069342,899,1066945,1067742,712,1068454
159,28,28,1075369,1075819,466,1073771,1074556,807,1075363
160,32,32,1082229,1082745,532,1080580,1081370,852,1082222
161,42,42,1089154,1089837,700,1087390,1088184,965,1089149
162,6,6,1095980,1096064,100,1094216,1094998,977,1095975
163,12,12,1102573,1102756,200,1101025,1101812,755,1102567
164,18,18,1109266,1109549,300,1107834,1108626,633,1109259
165,30,30,1115959,1116441,499,1114643,1115440,512,1115952
166,44,44,1123151,1123867,732,1121469,1122254,890,1123144
167,56,56,1129977,1130892,932,1128279,1129068,903,1129971
168,26,26,1136636,1137052,433,1135088,1135882,748,1136630
169,20,20,1143296,1143612,333,1141897,1142696,593,1143289
170,56,56,1150122,1151037,932,1148723,1149510,605,1150115
171,40,40,1157264,1157913,666,1155532,1156324,933,1157257
172,56,56,1164073,1164989,932,1162342,1163138,929,1164067
173,60,60,1170683,1171665,999,1169168,1169952,725,1170677
174,34,34,1177475,1178025,566,1175977,1176766,703,1177469
175,48,48,1184568,1185350,799,1182786,1183580,981,1184561
176,44,44,1191077,1191793,733,1189595,1190394,676,1191070
177,60,60,1198120,1199102,998,1196421,1197208,905,1198113
178,10,10,1204679,1204829,167,1203231,1204022,651,1204673
179,12,12,1211721,1211905,200,1210040,1210836,879,1211715
180,56,56,1218181,1219097,932,1216866,1217650,525,1218175
181,34,34,1225090,1225640,566,1223675,1224464,620,1225084
182,48,48,1231900,1232682,799,1230484,1231278,615,1231893
183,18,18,1238659,1238942,300,1237294,1238092,561,1238653
184,14,14,1245685,1245901,233,1244120,1244906,773,1245679
185,18,18,1252228,1252511,299,1250929,1251720,501,1252221
186,60,60,1259170,1260152,999,1257738,1258534,629,1259163
187,56,56,1266113,1267028,932,1264564,1265348,758,1266106
188,18,18,1273105,1273388,300,1271373,1272162,936,1273098
189,44,44,1279548,1280264,733,1278183,1278976,566,1279542
190,18,18,1286540,1286823,300,1284992,1285790,744,1286534
191,8,8,1293466,1293583,133,1291818,1292604,856,1293460
192,34,34,1300026,1300575,566,1298627,1299418,601,1300019
193,10,10,1306768,1306918,167,1305437,1306232,530,1306762
194,2,2,1313827,1313844,34,1312263,1313046,776,1313822
195,34,34,1320454,1321003,566,1319072,1319860,587,1320447
196,26,26,1327579,1327995,433,1325881,1326674,899,1327573
197,28,28,1334139,1334588,466,1332690,1333488,644,1334132
198,58,58,1340815,1341764,966,1339516,1340302,506,1340808
199,34,34,1347841,1348390,566,1346326,1347116,719,1347835
200,4,4,1354450,1354500,67,1353135,1353930,514,1354444
201,22,22,1361343,1361692,366,1359961,1360744,592,1361336
202,58,58,1368069,1369018,965,1366770,1367558,504,1368062
203,18,18,1375044,1375327,300,1373579,1374372,666,1375038
204,42,42,1381737,1382420,699,1380389,1381186,545,1381731
205,14,14,1388896,1389113,233,1387215,1388000,890,1388890
206,58,58,1395655,1396604,966,1394024,1394814,835,1395649
207,18,18,1402182,1402465,299,1400833,1401628,547,1402175
208,40,40,1409024,1409674,666,1407659,1408442,576,1409018
209,20,20,1415850,1416167,333,1414468,1415256,587,1415843
210,56,56,1422660,1423575,932,1421278,1422070,583,1422653
211,48,48,1429452,1430235,799,1428087,1428884,562,1429446
212,60,60,1436644,1437627,999,1434913,1435698,940,1436638
213,34,34,1443387,1443936,566,1441722,1442512,869,1443381
214,26,26,1450146,1450563,433,1448531,1449326,814,1450140
215,46,46,1456939,1457688,766,1455357,1456140,792,1456932
216,44,44,1463465,1464181,733,1462167,1462954,505,1463459
217,22,22,1470741,1471090,366,1468976,1469768,967,1470735
218,50,50,1477084,1477900,832,1475785,1476582,495,1477077
219,20,20,1483976,1484293,333,1482611,1483396,574,1483970
220,56,56,1490902,1491818,933,1489420,1490210,685,1490895
221,42,42,1497562,1498244,699,1496230,1497024,531,1497555
222,50,50,1504504,1505320,833,1503039,1503838,660,1504498
223,20,20,1511413,1511730,333,1509865,1510652,755,1511407
224,24,24,1518256,1518639,399,1516674,1517466,783,1518249
225,56,56,1525182,1526097,932,1523484,1524280,896,1525176
226,40,40,1531908,1532557,666,1530309,1531094,807,1531901
227,54,54,1538551,1539433,899,1537119,1537908,636,1538544
228,8,8,1545243,1545360,134,1543928,1544722,515,1545237
229,38,38,1552269,1552885,633,1550737,1551536,726,1552262
230,34,34,1559095,1559644,566,1557563,1558350,738,1559088
231,12,12,1565671,1565854,200,1564373,1565164,501,1565665
232,32,32,1572680,1573196,533,1571182,1571978,696,1572674
233,18,18,1579573,1579856,299,1578008,1578792,775,1579567
234,26,26,1586299,1586715,433,1584817,1585606,686,1586292
235,44,44,1592992,1593707,732,1591626,1592420,565,1592985
236,52,52,1599984,1600833,866,1598436,1599234,744,1599978
237,24,24,1605811,1606194,400,1605262,1605265,539,1605804
238,24,24,1612654,1613036,399,1611288,1612079,568,1612647
239,2,2,1619579,1619596,34,1618098,1618893,680,1619573
240,58,58,1626505,1627454,966,1624924,1625707,792,1626499
241,6,6,1633098,1633181,100,1631733,1632521,571,1633092
242,10,10,1640307,1640457,166,1638542,1639335,966,1640301
243,50,50,1647116,1647932,833,1645351,1646149,961,1647110
244,54,54,1653509,1654392,899,1652177,1652963,539,1653502
245,58,58,1660352,1661301,965,1658987,1659777,569,1660346
246,10,10,1667444,1667594,167,1665796,1666591,847,1667438
247,8,8,1674054,1674170,133,1672622,1673405,642,1674047
248,48,48,1680813,1681595,799,1679431,1680219,587,1680806
249,28,28,1687905,1688355,466,1686240,1687033,866,1687899
250,34,34,1694798,1695347,566,1693050,1693847,945,1694792
251,20,20,1701208,1701524,333,1699876,1700661,540,1701201
252,34,34,1708133,1708683,566,1706685,1707475,652,1708127
253,40,40,1715076,1715725,666,1713494,1714289,780,1715069
254,36,36,1721819,1722401,599,1720320,1721103,709,1721812
255,22,22,1728894,1729244,367,1727129,1727917,971,1728888
256,32,32,1735554,1736070,532,1733939,1734731,817,1735548
257,12,12,1742446,1742629,200,1740748,1741545,895,1742440
258,52,52,1749172,1750021,866,1747574,1748359,807,1749166
259,38,38,1755732,1756348,632,1754383,1755173,552,1755725
260,4,4,1762841,1762891,66,1761193,1761987,848,1762835
261,44,44,1769450,1770166,733,1768018,1768801,642,1769443
262,24,24,1776309,1776692,400,1774828,1775615,688,1776303
263,54,54,1783269,1784151,899,1781637,1782429,833,1783262
264,34,34,1790111,1790661,566,1788446,1789243,862,1790105
265,46,46,1796604,1797353,766,1795272,1796057,540,1796597
266,10,10,1803480,1803630,167,1802082,1802871,603,1803474
267,12,12,1810323,1810506,199,1808891,1809685,631,1810316
268,36,36,1817398,1817981,600,1815700,1816499,893,1817392
269,36,36,1824158,1824740,599,1822526,1823313,838,1824151
270,24,24,1831050,1831433,400,1829335,1830127,917,1831044
271,36,36,1837809,1838392,600,1836145,1836941,863,1837804
272,44,44,1844585,1845301,733,1842971,1843755,825,1844580
273,40,40,1851395,1852044,666,1849780,1850569,820,1851389
274,36,36,1858137,1858720,600,1856589,1857383,748,1858131
275,18,18,1864730,1865013,300,1863398,1864197,526,1864723
276,52,52,1871639,1872489,866,1870224,1871011,622,1871633
277,36,36,1878782,1879364,599,1877034,1877825,951,1878776
278,28,28,1885291,1885741,467,1883843,1884639,646,1885285
279,52,52,1892201,1893050,865,1890669,1891453,741,1892194
280,6,6,1898910,1898993,100,1897478,1898267,636,1898903
281,42,42,1905802,1906485,700,1904287,1905081,715,1905796
282,10,10,1912562,1912712,166,1911097,1911895,661,1912556
283,58,58,1919221,1920170,966,1917923,1918709,506,1919215
284,8,8,1926097,1926214,133,1924732,1925523,568,1926091
285,56,56,1933073,1933989,932,1931541,1932337,729,1933066
286,42,42,1939932,1940615,699,1938367,1939151,775,1939926
287,60,60,1946625,1947607,999,1945176,1945965,653,1946618
288,48,48,1953284,1954067,799,1951986,1952779,499,1953278
289,52,52,1960127,1960976,866,1958795,1959593,527,1960120
290,44,44,1967236,1967952,732,1965621,1966407,823,1967230
291,2,2,1973779,1973795,33,1972430,1973221,551,1973772
292,36,36,1980838,1981420,599,1979240,1980035,797,1980832
293,58,58,1987531,1988480,965,1986065,1986849,675,1987524
294,48,48,1993691,1994473,799,1992875,1992880,804,1993684
295,40,40,2000250,2000899,666,1998902,1999694,550,2000244
296,4,4,2007026,2007076,67,2005711,2006508,512,2007020
297,42,42,2014168,2014851,700,2012537,2013322,840,2014162
298,26,26,2021111,2021527,433,2019346,2020136,969,2021105
299,20,20,2027537,2027853,333,2026155,2026950,580,2027530
300,8,8,2034430,2034546,133,2032981,2033764,659,2034423
301,18,18,2041222,2041505,300,2039791,2040578,638,2041216
302,20,20,2048132,2048448,333,2046600,2047392,733,2048125
303,40,40,2054758,2055407,666,2053409,2054206,545,2054751
304,30,30,2061833,2062316,500,2060235,2061020,807,2061827
305,48,48,2068593,2069375,799,2067044,2067834,752,2068586
306,10,10,2075469,2075618,166,2073854,2074648,815,2075463
307,10,10,2082145,2082294,166,2080680,2081462,677,2082139
308,10,10,2089154,2089304,166,2087489,2088276,872,2089148
309,22,22,2095663,2096013,367,2094298,2095090,567,2095657
310,56,56,2102606,2103521,932,2101107,2101904,695,2102599
311,56,56,2109348,2110264,933,2107933,2108718,624,2109342
312,20,20,2116041,2116358,333,2114743,2115532,503,2116035
313,46,46,2123250,2123999,766,2121552,2122346,898,2123244
314,56,56,2129826,2130742,933,2128361,2129160,660,2129820
315,18,18,2136569,2136852,300,2135187,2135974,588,2136562
316,56,56,2143495,2144410,932,2141996,2142788,700,2143488
317,42,42,2150454,2151137,699,2148806,2149602,846,2150448
318,2,2,2156980,2156997,34,2155632,2156416,558,2156974
319,40,40,2164122,2164772,666,2162441,2163230,886,2164116
320,54,54,2170599,2171481,899,2169250,2170044,548,2170592
321,42,42,2177791,2178474,699,2176060,2176858,927,2177785
322,54,54,2184317,2185200,899,2182885,2183672,638,2184310
323,52,52,2190227,2191077,866,2189695,2189703,517,2190220
324,52,52,2197203,2198052,866,2195722,2196517,680,2197197
325,56,56,2204212,2205128,933,2202547,2203331,875,2204206
326,10,10,2211105,2211255,166,2209357,2210145,954,2211099
327,56,56,2217881,2218797,932,2216166,2216959,916,2217875
328,46,46,2224407,2225156,766,2222975,2223773,627,2224400
329,18,18,2231116,2231400,300,2229801,2230587,523,2231110
330,36,36,2238325,2238908,600,2236611,2237401,919,2238320
331,58,58,2244785,2245734,966,2243420,2244215,564,2244779
332,58,58,2251544,2252493,966,2250246,2251029,509,2251538
333,10,10,2258770,2258920,166,2257055,2257843,921,2258764
334,42,42,2265296,2265979,699,2263864,2264657,632,2265289
335,14,14,2272438,2272655,233,2270674,2271471,962,2272433
336,24,24,2279048,2279431,399,2277500,2278285,757,2279042
337,4,4,2286007,2286057,67,2284309,2285099,902,2286001
338,22,22,2292550,2292900,366,2291118,2291913,630,2292543
339,56,56,2299359,2300275,933,2297944,2298727,626,2299353
340,40,40,2306452,2307101,665,2304753,2305541,904,2306445
341,34,34,2313311,2313860,566,2311563,2312355,950,2313305
342,40,40,2320153,2320803,666,2318372,2319169,978,2320147
343,42,42,2326896,2327579,699,2325198,2325983,907,2326890
344,58,58,2333406,2334355,965,2332007,2332797,602,2333399
345,10,10,2340298,2340448,167,2338816,2339611,680,2340291
346,24,24,2347407,2347790,400,2345642,2346425,976,2347401
347,20,20,2353983,2354300,333,2352452,2353239,738,2353977
348,56,56,2360626,2361542,932,2359261,2360053,567,2360620
349,48,48,2367685,2368468,799,2366070,2366867,812,2367679
350,34,34,2374561,2375110,566,2372896,2373681,874,2374555
351,18,18,2381237,2381520,300,2379705,2380495,735,2381230
352,40,40,2387813,2388463,666,2386515,2387309,498,2387807
353,18,18,2394956,2395239,299,2393324,2394123,826,2394949
354,44,44,2401548,2402264,733,2400150,2400937,605,2401542
355,56,56,2408624,2409540,932,2406959,2407751,867,2408618
356,48,48,2415350,2416133,799,2413769,2414565,779,2415344
357,26,26,2422176,2422592,433,2420594,2421379,790,2422169
358,30,30,2429119,2429601,499,2427404,2428193,920,2429113
359,44,44,2435611,2436327,733,2434213,2435007,598,2435605
360,24,24,2442554,2442937,400,2441022,2441821,726,2442547
361,12,12,2449546,2449730,200,2447848,2448635,905,2449540
362,22,22,2456206,2456555,366,2454658,2455449,751,2456200
363,28,28,2462982,2463431,466,2461467,2462263,713,2462976
364,36,36,2469891,2470474,599,2468293,2469077,808,2469885
365,48,48,2476784,2477566,799,2475102,2475891,886,2476777
366,38,38,2483526,2484142,633,2481911,2482705,815,2483520
367,40,40,2490052,2490702,666,2488721,2489519,527,2490046
368,6,6,2497328,2497411,100,2495547,2496333,989,2497322
369,18,18,2503838,2504121,299,2502356,2503147,684,2503831
370,52,52,2510514,2511363,865,2509165,2509961,546,2510507
371,50,50,2517456,2518272,833,2515991,2516775,675,2517450
372,12,12,2524465,2524648,200,2522800,2523589,870,2524459
373,16,16,2531358,2531607,266,2529610,2530403,949,2531352
374,54,54,2537917,2538800,899,2536419,2537217,694,2537911
375,28,28,2544876,2545326,467,2543245,2544031,839,2544870
376,2,2,2551619,2551636,33,2550054,2550845,768,2551613
377,48,48,2558478,2559261,799,2556863,2557659,813,2558472
378,32,32,2565104,2565621,533,2563689,2564473,625,2565098
379,8,8,2571814,2571930,133,2570499,2571287,521,2571808
380,16,16,2578656,2578906,267,2577308,2578101,549,2578650
381,60,60,2585532,2586515,999,2584117,2584915,611,2585526
382,10,10,2592708,2592858,166,2590943,2591729,973,2592702
383,38,38,2599151,2599767,633,2597752,2598543,601,2599144
384,56,56,2606060,2606976,932,2604562,2605357,697,2606054
385,58,58,2613102,2614051,966,2611388,2612171,926,2613097
386,22,22,2619679,2620028,366,2618197,2618985,687,2619672
387,42,42,2626604,2627287,700,2625006,2625799,799,2626598
388,34,34,2633547,2634096,566,2631815,2632613,927,2633540
389,6,6,2640223,2640306,100,2638641,2639427,789,2640216
390,46,46,2647132,2647881,766,2645451,2646241,885,2647126
391,16,16,2653991,2654241,267,2652260,2653055,930,2653985
392,12,12,2660767,2660951,200,2659086,2659869,892,2660761
393,18,18,2667227,2667510,300,2665895,2666683,537,2667220
394,22,22,2674253,2674602,366,2672704,2673497,749,2674246
395,30,30,2680879,2681362,499,2679514,2680311,562,2680873
396,10,10,2688021,2688171,167,2686340,2687125,890,2688015
397,56,56,2694914,2695829,932,2693149,2693939,969,2694908
398,54,54,2701440,2702322,899,2699958,2700753,680,2701433
399,50,50,2708432,2709248,833,2706784,2707567,859,2708426
400,58,58,2715009,2715958,965,2713594,2714381,622,2715003
401,16,16,2721868,2722118,266,2720403,2721195,667,2721862
402,4,4,2728710,2728760,67,2727212,2728009,695,2728704
403,48,48,2735570,2736352,799,2734038,2734823,740,2735563
404,16,16,2742579,2742828,266,2740847,2741637,935,2742572
405,36,36,2749072,2749654,599,2747657,2748451,615,2749066
406,48,48,2755881,2756663,799,2754483,2755265,610,2755875
407,6,6,2762907,2762990,100,2761292,2762079,822,2762901
408,2,2,2769466,2769483,34,2768101,2768893,567,2769460
409,50,50,2776542,2777358,832,2774910,2775707,828,2776535
410,48,48,2783251,2784034,799,2781736,2782521,724,2783245
411,10,10,2790210,2790360,167,2788546,2789335,870,2790205
412,40,40,2797086,2797736,666,2795355,2796149,931,2797080
413,50,50,2803746,2804562,832,2802164,2802963,776,2803739
414,24,24,2810722,2811104,399,2808990,2809777,938,2810715
415,32,32,2816349,2816865,533,2815799,2815808,533,2816341
416,60,60,2823175,2824157,999,2821826,2822622,546,2823168
417,30,30,2830350,2830833,500,2828652,2829436,908,2830344
418,22,22,2836877,2837226,366,2835461,2836250,620,2836870
419,50,50,2844002,2844818,833,2842271,2843064,932,2843996
420,36,36,2850445,2851028,600,2849080,2849878,561,2850439
421,2,2,2857671,2857687,33,2855906,2856692,973,2857665
422,28,28,2864480,2864929,466,2862715,2863506,968,2864474
423,50,50,2871089,2871905,833,2869524,2870320,763,2871083
424,18,18,2878115,2878398,300,2876350,2877134,975,2878109
425,40,40,2884808,2885457,666,2883160,2883948,854,2884802
426,44,44,2891268,2891983,732,2889969,2890762,499,2891261
427,46,46,2898193,2898943,766,2896778,2897576,611,2898187
428,30,30,2905369,2905852,499,2903604,2904390,973,2905363
429,58,58,2912112,2913061,965,2910413,2911204,901,2912105
430,22,22,2918854,2919204,367,2917223,2918018,830,2918848
431,18,18,2925664,2925947,299,2924049,2924832,826,2925658
432,30,30,2932589,2933072,500,2930858,2931646,937,2932583
433,48,48,2939249,2940031,799,2937667,2938460,782,2939242
434,20,20,2946158,2946474,333,2944477,2945274,878,2946152
435,58,58,2952701,2953650,966,2951303,2952088,607,2952695
436,52,52,2959527,2960376,866,2958112,2958902,619,2959521
437,42,42,2966353,2967035,699,2964921,2965716,630,2966346
438,4,4,2973362,2973412,67,2971747,2972530,826,2973356
439,8,8,2980338,2980454,133,2978556,2979344,987,2980331
440,34,34,2986881,2987430,566,2985366,2986158,717,2986875
441,48,48,2993823,2994606,799,2992175,2992972,845,2993817
442,14,14,3000316,3000532,233,2999001,2999786,524,3000310
443,32,32,3007259,3007775,532,3005810,3006600,652,3007252
444,8,8,3014168,3014284,133,3012619,3013414,747,3014161
445,16,16,3021010,3021260,267,3019445,3020228,776,3021004
446,24,24,3028003,3028386,399,3026255,3027042,955,3027997
447,60,60,3034529,3035511,999,3033064,3033856,667,3034523
448,2,2,3041655,3041671,33,3039873,3040670,978,3041648
449,36,36,3048480,3049063,600,3046699,3047484,990,3048474
450,14,14,3055256,3055473,234,3053508,3054298,952,3055250
451,2,2,3061883,3061899,33,3060318,3061112,765,3061877
452,8,8,3068642,3068759,133,3067144,3067926,710,3068636
453,18,18,3075651,3075934,300,3073953,3074740,905,3075645
454,46,46,3082494,3083243,765,3080762,3081554,933,3082487
455,40,40,3088970,3089619,666,3087571,3088368,595,3088963
456,52,52,3095896,3096745,866,3094397,3095182,707,3095889
457,58,58,3102971,3103920,966,3101207,3101996,970,3102966
458,18,18,3109581,3109864,300,3108016,3108810,765,3109575
459,14,14,3116407,3116623,233,3114825,3115624,776,3116400
460,56,56,3123383,3124298,932,3121651,3122438,938,3123376
461,26,26,3130159,3130575,433,3128460,3129252,900,3130152
462,8,8,3137068,3137184,133,3135270,3136066,996,3137062
463,12,12,3143428,3143611,199,3142096,3142880,541,3143421
464,40,40,3150320,3150969,666,3148905,3149694,620,3150314
465,2,2,3157279,3157296,34,3155714,3156508,765,3157273
466,4,4,3164105,3164155,67,3162524,3163322,777,3164099
467,36,36,3171064,3171647,600,3169349,3170136,922,3171058
468,16,16,3177491,3177740,266,3176159,3176950,534,3177484
469,48,48,3184633,3185415,799,3182968,3183764,863,3184627
470,10,10,3191559,3191709,166,3189794,3190578,975,3191553
471,50,50,3198335,3199151,832,3196603,3197392,936,3198328
472,6,6,3205077,3205161,100,3203413,3204206,866,3205072
473,14,14,3211587,3211803,233,3210222,3211020,561,3211581
474,16,16,3218513,3218763,266,3217048,3217834,673,3218507
475,44,44,3225589,3226304,732,3223857,3224648,934,3225582
476,38,38,3232032,3232648,632,3230666,3231462,563,3232025
477,56,56,3239041,3239956,932,3237492,3238276,758,3239034
478,60,60,3245933,3246915,999,3244302,3245090,837,3245927
479,16,16,3252659,3252909,267,3251111,3251904,749,3252653
480,8,8,3259468,3259585,134,3257920,3258718,744,3259462
481,50,50,3266478,3267293,832,3264746,3265532,939,3266471
482,18,18,3273220,3273503,300,3271555,3272346,868,3273214
483,42,42,3280013,3280695,699,3278365,3279160,847,3280007
484,2,2,3286839,3286855,33,3285191,3285974,859,3286833
485,42,42,3293348,3294031,700,3292000,3292788,554,3293342
486,46,46,3300457,3301207,766,3298809,3299602,849,3300451
487,10,10,3307034,3307183,166,3305618,3306416,611,3307027
488,46,46,3313860,3314609,765,3312444,3313230,623,3313853
489,28,28,3320968,3321418,467,3319254,3320044,919,3320963
490,58,58,3327495,3328444,965,3326063,3326858,630,3327488
491,10,10,3334287,3334437,167,3332889,3333672,609,3334281
492,30,30,3341030,3341513,500,3339698,3340486,537,3341023
493,52,52,3348139,3348988,866,3346507,3347300,832,3348132
494,48,48,3354965,3355747,799,3353317,3354114,845,3354959
495,16,16,3361674,3361924,267,3360143,3360928,740,3361668
496,48,48,3368517,3369299,799,3366952,3367742,769,3368511
497,16,16,3375526,3375776,266,3373761,3374556,964,3375520
498,12,12,3382219,3382402,200,3380587,3381370,842,3382212
499,56,56,3388928,3389844,932,3387396,3388184,737,3388921
500,18,18,3395804,3396087,300,3394206,3394998,800,3395798
501,24,24,3402597,3402980,399,3401015,3401812,778,3402590
502,46,46,3409156,3409905,766,3407841,3408626,524,3409150
503,28,28,3416348,3416798,467,3414650,3415440,902,3416342
504,42,42,3423158,3423840,699,3421460,3422254,898,3423152
505,28,28,3430050,3430500,466,3428285,3429068,976,3430044
506,2,2,3436660,3436676,33,3435095,3435882,772,3436654
507,10,10,3443536,3443685,166,3441904,3442696,833,3443529
508,28,28,3450378,3450828,466,3448713,3449510,862,3450372
509,46,46,3456988,3457737,766,3455539,3456324,657,3456981
510,22,22,3463897,3464246,366,3462349,3463138,753,3463891
511,42,42,3470723,3471405,699,3469158,3469952,765,3470717
512,2,2,3477432,3477449,34,3475967,3476766,660,3477426
513,38,38,3484375,3484991,632,3482793,3483580,788,3484368
514,12,12,3491284,3491467,200,3489602,3490394,883,3491277
515,42,42,3497993,3498676,700,3496412,3497208,779,3497987
516,60,60,3504669,3505652,999,3503238,3504022,641,3504663
517,10,10,3511812,3511961,166,3510047,3510836,970,3511806
518,14,14,3518205,3518421,233,3516856,3517650,548,3518198
519,30,30,3524581,3525064,500,3523665,3523681,893,3524574
520,18,18,3531124,3531407,300,3529709,3530495,623,3531118
521,2,2,3537917,3537933,33,3536518,3537309,601,3537910
522,14,14,3544909,3545125,233,3543327,3544123,779,3544902
523,44,44,3551835,3552551,732,3550153,3550937,891,3551828
524,48,48,3558511,3559293,799,3556963,3557751,754,3558505
525,2,2,3565537,3565553,33,3563772,3564565,966,3565531
526,18,18,3571996,3572279,300,3570581,3571379,611,3571990
527,60,60,3578839,3579821,999,3577407,3578193,639,3578832
528,16,16,3585715,3585965,266,3584216,3585007,701,3585708
529,10,10,3592674,3592824,166,3591026,3591821,847,3592668
530,60,60,3599517,3600499,998,3597852,3598635,876,3599511
531,2,2,3606043,3606059,33,3604661,3605449,587,3606036
532,12,12,3613218,3613401,200,3611470,3612263,949,3613212
533,42,42,3619578,3620261,699,3618280,3619077,495,3619572
534,38,38,3626720,3627336,633,3625105,3625891,823,3626714
535,16,16,3633263,3633513,267,3631915,3632705,552,3633257
536,26,26,3640206,3640622,433,3638724,3639519,680,3640199
537,28,28,3647148,3647598,466,3645550,3646333,809,3647142
538,10,10,3653841,3653991,166,3652359,3653147,687,3653834
539,48,48,3660900,3661682,799,3659169,3659961,933,3660894
540,24,24,3667759,3668142,400,3665978,3666775,978,3667753
541,42,42,3674335,3675018,700,3672804,3673589,740,3674329
542,36,36,3681061,3681644,600,3679613,3680403,652,3681055
543,58,58,3687871,3688820,965,3686422,3687217,647,3687864
544,54,54,3694896,3695779,900,3693248,3694031,859,3694890
545,46,46,3701589,3702338,766,3700058,3700845,738,3701583
546,18,18,3708415,3708698,300,3706867,3707659,750,3708409
547,20,20,3715191,3715507,333,3713676,3714473,712,3715185
548,36,36,3722034,3722616,599,3720502,3721287,740,3722027
549,28,28,3729043,3729492,466,3727311,3728101,935,3729036
550,56,56,3735536,3736451,932,3734121,3734915,615,3735530
551,50,50,3742628,3743444,833,3740947,3741729,893,3742622
552,34,34,3749437,3749987,566,3747756,3748543,888,3749431
553,40,40,3756113,3756763,666,3754565,3755357,750,3756107
554,26,26,3762790,3763206,432,3761374,3762171,612,3762783
555,16,16,3769782,3770032,266,3768200,3768985,790,3769775
556,20,20,3776575,3776891,333,3775010,3775799,770,3776569
557,46,46,3783600,3784350,766,3781819,3782613,981,3783594
558,24,24,3790293,3790676,400,3788628,3789427,860,3790287
559,34,34,3797152,3797702,566,3795454,3796241,905,3797146
560,8,8,3803595,3803712,134,3802263,3803055,533,3803588
561,2,2,3810754,3810771,34,3809073,3809869,879,3810748
562,18,18,3817347,3817630,300,3815899,3816683,658,3817341
563,36,36,3824290,3824872,599,3822708,3823497,786,3824283
564,48,48,3831066,3831848,799,3829517,3830311,748,3831059
565,58,58,3837858,3838807,966,3836326,3837125,726,3837851
566,2,2,3844518,3844534,33,3843152,3843939,572,3844511
567,12,12,3851577,3851760,199,3849962,3850753,818,3851571
568,36,36,3858203,3858785,599,3856771,3857567,629,3858196
569,58,58,3865162,3866111,966,3863597,3864381,775,3865156
570,32,32,3871921,3872437,533,3870406,3871195,720,3871915
571,22,22,3878830,3879180,367,3877216,3878009,816,3878825
572,48,48,3885623,3886406,799,3884025,3884823,794,3885617
573,4,4,3892316,3892366,66,3890851,3891637,673,3892310
574,54,54,3899108,3899991,899,3897660,3898451,651,3899102
575,30,30,3906101,3906584,499,3904469,3905265,829,3906094
576,42,42,3913060,3913743,699,3911295,3912079,975,3913054
577,10,10,3919553,3919703,166,3918105,3918893,654,3919547
578,4,4,3926445,3926495,67,3924914,3925707,732,3926439
579,46,46,3933188,3933937,766,3931723,3932521,661,3933182
580,6,6,3940131,3940214,100,3938549,3939335,789,3940124
581,28,28,3946740,3947190,466,3945358,3946149,584,3946733
582,60,60,3953783,3954765,998,3952168,3952963,814,3953777
583,2,2,3960442,3960459,33,3958994,3959777,659,3960436
584,28,28,3967551,3968000,466,3965803,3966591,954,3967545
585,30,30,3973911,3974394,499,3972612,3973405,499,3973904
586,40,40,3980820,3981469,666,3979421,3980219,594,3980813
587,48,48,3987846,3988628,799,3986247,3987033,806,3987839
588,38,38,3994705,3995321,632,3993057,3993847,852,3994699
589,4,4,4001298,4001348,66,3999866,4000661,630,4001291
590,38,38,4008174,4008790,632,4006692,4007475,692,4008167
591,12,12,4014816,4014999,200,4013501,4014289,521,4014810
592,10,10,4021875,4022025,167,4020310,4021103,766,4021869
593,40,40,4028535,4029184,666,4027120,4027917,612,4028529
594,26,26,4035494,4035910,433,4033946,4034731,757,4035488
595,14,14,4042253,4042470,233,4040755,4041545,702,4042247
596,2,2,4049079,4049096,34,4047564,4048359,714,4049073
597,20,20,4055938,4056255,333,4054390,4055173,759,4055932
598,40,40,4062964,4063613,666,4061199,4061987,971,4062958
599,4,4,4069674,4069723,66,4068009,4068801,867,4069668
600,22,22,4076533,4076882,366,4074818,4075615,912,4076527
601,16,16,4083109,4083359,266,4081644,4082429,674,4083103
602,54,54,4090118,4091000,899,4088453,4089243,869,4090112
603,4,4,4096911,4096961,66,4095262,4096057,847,4096904
604,58,58,4103470,4104419,966,4102088,4102871,592,4103463
605,34,34,4110379,4110929,567,4108898,4109685,688,4110373
606,42,42,4117006,4117688,699,4115707,4116499,500,4116999
607,40,40,4124164,4124814,666,4122516,4123313,845,4124158
608,14,14,4131024,4131240,233,4129342,4130127,890,4131017
609,4,4,4137633,4137683,67,4136151,4136941,685,4137626
610,32,32,4144709,4145225,533,4142961,4143755,948,4144703
611,28,28,4151502,4151951,466,4149770,4150569,926,4151495
612,40,40,4158261,4158910,666,4156596,4157383,872,4158255
613,42,42,4165120,4165803,699,4163405,4164197,917,4165114
614,58,58,4171613,4172562,966,4170215,4171011,596,4171607
615,10,10,4178772,4178922,166,4177041,4177825,941,4178766
616,10,10,4185348,4185498,167,4183850,4184639,703,4185342
617,16,16,4192191,4192440,266,4190659,4191453,731,4192184
618,42,42,4198800,4199483,700,4197468,4198267,526,4198793
619,18,18,4205876,4206159,300,4204294,4205081,788,4205869
620,48,48,4212402,4213185,799,4211104,4211895,501,4212396
621,10,10,4219611,4219761,167,4217913,4218709,896,4219605
622,14,14,4226470,4226687,233,4224739,4225523,941,4226464
623,42,42,4232930,4233613,699,4231548,4232337,586,4232923
624,24,24,4239689,4240072,400,4238357,4239151,531,4239682
625,40,40,4246499,4247148,666,4245167,4245965,527,4246492
626,36,36,4253541,4254124,599,4251993,4252779,756,4253535
627,32,32,4260134,4260650,533,4258802,4259593,534,4260127
628,38,38,4267276,4267892,633,4265611,4266407,863,4267270
629,38,38,4274035,4274651,633,4272437,4273221,808,4274029
630,14,14,4280845,4281061,233,4279246,4280035,803,4280838
631,36,36,4287754,4288337,599,4286056,4286849,899,4287748
632,28,28,4294463,4294913,466,4292865,4293663,794,4294457
633,22,22,4301256,4301605,366,4299691,4300477,773,4301250
634,48,48,4308098,4308881,800,4306500,4307291,801,4308092
635,4,4,4314608,4314658,67,4313309,4314105,496,4314601
636,12,12,4321700,4321883,200,4320135,4320919,775,4321694
637,46,46,4328643,4329392,766,4326945,4327733,904,4328637
638,44,44,4335419,4336135,732,4333754,4334547,866,4335413
639,58,58,4342195,4343144,965,4340563,4341361,827,4342188
640,2,2,4349054,4349071,33,4347389,4348175,873,4349048
641,20,20,4355980,4356296,333,4354198,4354989,984,4355973
642,12,12,4362306,4362489,200,4361008,4361803,497,4362300
643,22,22,4369232,4369582,366,4367834,4368617,609,4369226
644,28,28,4376075,4376524,466,4374643,4375431,637,4376068
645,8,8,4383084,4383200,133,4381452,4382245,832,4383077
646,36,36,4389677,4390259,599,4388262,4389059,612,4389671
647,56,56,4396453,4397368,932,4395087,4395873,573,4396446
648,44,44,4403378,4404094,733,4401897,4402687,685,4403372
649,32,32,4410171,4410687,533,4408706,4409501,664,4410165
650,42,42,4417014,4417696,699,4415532,4416315,692,4417007
651,22,22,4423840,4424189,366,4422341,4423129,704,4423833
652,58,58,4430832,4431781,966,4429151,4429943,883,4430826
653,48,48,4437658,4438440,799,4435960,4436757,895,4437652
654,14,14,4444068,4444284,233,4442786,4443571,490,4444061
655,22,22,4451243,4451593,367,4449595,4450385,852,4451237
656,20,20,4457253,4457570,333,4456404,4456416,830,4457246
657,22,22,4463730,4464079,366,4462431,4463230,493,4463723
658,36,36,4471038,4471621,600,4469257,4470044,988,4471032
659,18,18,4477515,4477798,299,4476066,4476858,650,4477508
660,44,44,4484324,4485040,733,4482876,4483672,646,4484318
661,30,30,4491317,4491799,499,4489702,4490486,825,4491311
662,46,46,4498292,4499041,766,4496511,4497300,986,4498286
663,42,42,4504635,4505318,700,4503320,4504114,515,4504629
664,26,26,4511445,4511861,433,4510129,4510928,510,4511438
665,46,46,4518537,4519286,766,4516955,4517742,788,4518530
666,52,52,4525180,4526029,866,4523765,4524556,618,4525174
667,4,4,4532255,4532305,67,4530574,4531370,879,4532249
668,16,16,4538948,4539198,267,4537400,4538184,758,4538942
669,24,24,4545558,4545941,399,4544209,4544998,553,4545551
670,14,14,4552450,4552667,233,4551018,4551812,631,4552443
671,52,52,4559359,4560208,866,4557828,4558626,727,4559353
672,20,20,4566002,4566319,333,4564654,4565440,556,4565996
673,34,34,4572795,4573344,566,4571463,4572254,534,4572788
674,20,20,4579637,4579954,333,4578272,4579068,563,4579631
675,52,52,4586746,4587595,866,4585098,4585882,858,4586740
676,46,46,4593689,4594438,766,4591907,4592696,986,4593682
677,58,58,4600182,4601131,965,4598717,4599510,666,4600176
678,14,14,4607108,4607324,233,4605526,4606324,777,4607101
679,22,22,4614017,4614366,366,4612352,4613138,873,4614011
680,56,56,4620760,4621675,932,4619161,4619952,801,4620753
681,18,18,4627619,4627902,299,4625971,4626766,847,4627613
682,12,12,4634212,4634395,199,4632796,4633580,625,4634205
683,20,20,4641171,4641487,333,4639606,4640394,771,4641165
684,60,60,4647780,4648763,999,4646415,4647208,566,4647774
685,54,54,4654590,4655472,899,4653224,4654022,561,4654583
686,16,16,4661382,4661632,267,4660050,4660836,539,4661375
687,36,36,4668624,4669207,600,4666860,4667650,969,4668619
688,48,48,4674984,4675767,799,4673669,4674464,514,4674978
689,40,40,4682260,4682909,665,4680495,4681278,976,4682254
690,46,46,4688703,4689452,765,4687304,4688092,604,4688696
691,22,22,4695645,4695995,366,4694113,4694906,732,4695638
692,36,36,4702304,4702887,600,4700923,4701720,578,4702298
693,48,48,4709047,4709830,799,4707749,4708534,507,4709041
694,34,34,4716106,4716656,566,4714558,4715348,752,4716100
695,44,44,4722682,4723398,733,4721367,4722162,514,4722676
696,30,30,4729492,4729974,499,4728193,4728976,509,4729485
697,16,16,4736701,4736950,266,4735002,4735790,904,4736694
698,28,28,4743243,4743693,467,4741812,4742604,633,4743237
699,8,8,4750169,4750286,133,4748621,4749418,745,4750163
700,4,4,4757212,4757262,66,4755447,4756232,974,4757206
701,4,4,4763988,4764038,66,4762256,4763046,935,4763981
702,60,60,4770664,4771646,999,4769065,4769860,797,4770657
703,58,58,4777623,4778572,965,4775891,4776674,942,4777616
704,10,10,4784482,4784632,167,4782701,4783488,988,4784476
705,36,36,4790908,4791491,600,4789510,4790302,600,4790902
706,34,34,4798051,4798600,566,4796319,4797116,928,4798044
707,12,12,4804927,4805110,199,4803145,4803930,990,4804920
708,2,2,4811686,4811703,33,4809954,4810744,935,4811679
709,46,46,4818528,4819278,766,4816764,4817558,965,4818523
710,12,12,4825238,4825421,200,4823573,4824372,860,4825232
711,38,38,4831897,4832513,633,4830399,4831186,705,4831891
712,8,8,4838523,4838640,134,4837208,4838000,517,4838517
713,52,52,4845483,4846332,865,4844018,4844814,663,4845477
714,24,24,4852475,4852858,400,4850843,4851628,840,4852468
715,42,42,4859318,4860000,699,4857653,4858442,870,4859312
716,48,48,4865894,4866676,799,4864462,4865256,631,4865887
717,8,8,4873036,4873153,133,4871271,4872070,960,4873030
718,56,56,4879546,4880461,932,4878097,4878884,655,4879539
719,56,56,4886455,4887371,932,4884907,4885698,751,4886449
720,44,44,4893181,4893897,732,4891716,4892512,663,4893175
721,6,6,4899907,4899990,100,4898542,4899326,575,4899901
722,24,24,4906899,4907282,400,4905351,4906140,753,4906893
723,28,28,4913642,4914092,466,4912160,4912954,681,4913635
724,32,32,4920451,4920967,533,4918970,4919768,677,4920445
725,8,8,4927077,4927194,134,4925796,4926582,489,4927071
726,34,34,4934270,4934819,566,4932605,4933396,868,4934264
727,56,56,4941079,4941995,932,4939414,4940210,863,4941073
728,50,50,4947639,4948454,832,4946240,4947024,608,4947632
729,14,14,4954781,4954997,233,4953049,4953838,936,4954774
730,18,18,4961257,4961540,300,4959859,4960652,599,4961251
731,16,16,4968433,4968682,266,4966668,4967466,961,4968427
732,26,26,4974809,4975225,433,4973494,4974280,523,4974803
733,52,52,4982051,4982900,866,4980303,4981094,951,4982045
734,54,54,4988761,4989643,899,4987112,4987908,846,4988754
735,14,14,4995220,4995437,233,4993938,4994722,491,4995213
736,4,4,5002462,5002512,67,5000748,5001536,921,5002457
737,20,20,5008972,5009288,333,5007557,5008350,616,5008966
738,4,4,5015781,5015831,67,5014366,5015164,611,5015775
739,24,24,5022857,5023240,400,5021192,5021978,873,5022851
740,14,14,5029533,5029750,233,5028001,5028792,734,5029526
741,50,50,5036426,5037241,832,5034811,5035606,814,5036420
742,4,4,5043052,5043102,66,5041637,5042420,626,5043046
743,46,46,5049745,5050494,765,5048446,5049234,504,5049738
744,54,54,5056937,5057819,899,5055255,5056048,882,5056930
745,4,4,5063530,5063580,66,5062065,5062862,662,5063524
746,42,42,5070389,5071071,699,5068890,5069676,706,5070382
747,58,58,5077481,5078430,966,5075700,5076490,985,5077475
748,40,40,5083808,5084457,666,5082509,5083304,497,5083801
749,14,14,5091083,5091299,233,5089335,5090118,959,5091077
750,58,58,5097826,5098775,965,5096144,5096932,887,5097819
751,50,50,5104269,5105085,832,5102954,5103746,517,5104263
752,36,36,5111161,5111744,600,5109763,5110560,595,5111155
753,26,26,5117921,5118337,433,5116589,5117374,540,5117914
754,56,56,5124880,5125795,932,5123398,5124188,685,5124873
755,24,24,5131989,5132372,399,5130207,5131002,980,5131982
756,52,52,5138748,5139597,866,5137033,5137816,926,5138742
757,30,30,5145374,5145857,500,5143843,5144630,738,5145368
758,16,16,5152067,5152317,266,5150652,5151444,617,5152061
759,2,2,5159126,5159143,33,5157461,5158258,862,5159120
760,52,52,5165952,5166801,866,5164287,5165072,874,5165946
761,42,42,5172561,5173244,700,5171096,5171886,669,5172555
762,24,24,5179421,5179804,399,5177906,5178700,715,5179415
763,46,46,5186247,5186996,765,5184732,5185514,727,5186241
764,34,34,5192906,5193455,566,5191541,5192328,572,5192900
765,60,60,5200098,5201080,999,5198350,5199142,950,5200092
766,24,24,5206558,5206941,399,5205159,5205956,595,5206551
767,60,60,5213650,5214632,999,5211985,5212770,874,5213644
768,2,2,5220176,5220193,34,5218795,5219584,586,5220170
769,42,42,5226952,5227635,700,5225604,5226398,548,5226946
770,18,18,5234145,5234428,299,5232413,5233212,926,5234138
771,10,10,5240771,5240921,166,5239239,5240026,738,5240764
772,54,54,5247730,5248612,899,5246048,5246840,883,5247723
773,8,8,5254339,5254456,134,5252858,5253654,679,5254333
774,56,56,5261132,5262048,932,5259684,5260468,658,5261126
775,22,22,5268258,5268607,366,5266493,5267282,970,5268252
776,2,2,5274834,5274851,33,5273302,5274096,731,5274827
777,58,58,5281910,5282858,965,5280111,5280910,993,5281903
778,48,48,5288419,5289202,799,5286937,5287724,688,5288412
779,40,40,5295428,5296078,666,5293747,5294538,884,5295422
780,6,6,5301921,5302004,100,5300556,5301352,563,5301915
781,36,36,5308780,5309363,600,5307382,5308166,608,5308774
782,10,10,5315505,5315655,167,5314190,5314980,519,5315499
783,48,48,5322798,5323580,799,5320999,5321794,997,5322791
784,44,44,5328641,5329357,733,5327825,5327825,809,5328634
785,52,52,5335467,5336316,866,5333852,5334639,822,5335461
786,30,30,5342193,5342676,500,5340662,5341453,734,5342187
787,14,14,5349202,5349419,233,5347471,5348267,929,5349196
788,52,52,5355629,5356478,865,5354297,5355081,541,5355622
789,58,58,5362854,5363803,966,5361106,5361895,953,5362848
790,22,22,5369663,5370013,367,5367915,5368709,948,5369657
791,40,40,5376073,5376722,666,5374725,5375523,544,5376067
792,46,46,5383265,5384015,766,5381551,5382337,923,5383260
793,32,32,5389975,5390491,532,5388360,5389151,818,5389969
794,60,60,5396618,5397600,998,5395169,5395965,646,5396611
795,4,4,5403327,5403377,67,5401995,5402779,541,5403320
796,44,44,5410169,5410885,733,5408804,5409593,570,5410163
797,16,16,5417045,5417295,267,5415614,5416407,632,5417039
798,34,34,5423938,5424487,566,5422423,5423221,711,5423932
799,22,22,5430880,5431230,367,5429249,5430035,839,5430874
800,48,48,5437790,5438572,799,5436058,5436849,934,5437783
801,44,44,5444399,5445115,733,5442867,5443663,729,5444392
802,18,18,5451342,5451625,299,5449693,5450477,858,5451335
803,20,20,5457934,5458251,333,5456503,5457291,637,5457928
804,58,58,5464610,5465559,966,5463312,5464105,499,5464604
805,12,12,5471486,5471669,200,5470121,5470919,561,5471480
806,20,20,5478495,5478812,333,5476947,5477733,756,5478489
807,16,16,5485438,5485688,266,5483756,5484547,884,5485431
808,50,50,5492347,5493163,833,5490566,5491361,980,5492341
809,32,32,5498973,5499489,533,5497392,5498175,792,5498967
810,28,28,5505533,5505982,466,5504201,5504989,537,5505526
811,42,42,5512325,5513008,700,5511010,5511803,516,5512319
812,34,34,5519351,5519901,566,5517819,5518617,727,5519344
813,58,58,5526427,5527376,965,5524645,5525431,989,5526420
814,46,46,5533153,5533902,766,5531455,5532245,902,5533147
815,6,6,5539995,5540079,100,5538264,5539059,930,5539989
816,20,20,5546655,5546971,333,5545090,5545873,776,5546649
817,2,2,5553264,5553281,34,5551899,5552687,571,5553258
818,52,52,5560190,5561039,866,5558708,5559501,682,5560183
819,6,6,5567133,5567216,100,5565518,5566315,812,5567127
820,20,20,5574042,5574358,333,5572344,5573129,907,5574036
821,58,58,5580735,5581684,965,5579153,5579943,785,5580728
822,46,46,5587294,5588043,766,5585962,5586757,530,5587287
823,20,20,5594237,5594553,333,5592788,5593571,659,5594230
824,2,2,5601379,5601396,33,5599597,5600385,987,5601372
825,10,10,5607839,5607988,166,5606407,5607199,633,5607832
826,8,8,5614665,5614781,133,5613216,5614013,645,5614658
827,36,36,5621524,5622106,599,5620042,5620827,690,5621517
828,42,42,5627700,5628383,700,5626851,5626858,835,5627693
829,24,24,5634426,5634809,400,5632878,5633672,748,5634420
830,26,26,5641036,5641452,433,5639687,5640486,543,5641029
831,24,24,5648145,5648528,399,5646513,5647300,838,5648138
832,40,40,5655004,5655653,666,5653323,5654114,884,5654998
833,58,58,5661747,5662696,965,5660132,5660928,813,5661741
834,38,38,5668356,5668972,633,5666958,5667742,608,5668350
835,36,36,5675232,5675815,600,5673767,5674556,670,5675226
836,58,58,5682208,5683157,966,5680576,5681370,831,5682201
837,8,8,5689117,5689234,133,5687386,5688184,927,5689111
838,8,8,5695876,5695993,134,5694212,5694998,873,5695871
839,50,50,5702786,5703601,832,5701021,5701812,968,5702780
840,12,12,5709162,5709345,200,5707830,5708626,529,5709155
841,54,54,5715971,5716854,899,5714656,5715440,525,5715965
842,38,38,5723147,5723763,633,5721465,5722254,886,5723140
843,60,60,5729806,5730789,999,5728275,5729068,732,5729800
844,26,26,5736632,5737049,433,5735084,5735882,744,5736626
845,16,16,5743492,5743741,266,5741910,5742696,789,5743485
846,20,20,5750501,5750817,333,5748719,5749510,984,5750494
847,24,24,5756894,5757277,399,5755528,5756324,563,5756887
848,14,14,5764036,5764252,233,5762354,5763138,891,5764029
849,22,22,5770912,5771261,366,5769164,5769952,954,5770906
850,26,26,5777438,5777854,433,5775973,5776766,666,5777432
851,22,22,5784347,5784697,367,5782782,5783580,761,5784341
852,28,28,5791256,5791706,467,5789608,5790394,856,5791250
853,8,8,5798032,5798149,134,5796417,5797208,818,5798026
854,46,46,5804675,5805424,766,5803227,5804022,647,5804669
855,56,56,5811584,5812500,933,5810053,5810836,742,5811578
856,8,8,5818260,5818377,134,5816862,5817650,604,5818254
857,36,36,5825436,5826019,599,5823671,5824464,966,5825430
858,24,24,5831929,5832312,400,5830481,5831278,645,5831923
859,30,30,5838971,5839454,500,5837306,5838092,873,5838965
860,36,36,5845481,5846064,599,5844116,5844906,569,5845475
861,26,26,5852290,5852706,433,5850925,5851720,564,5852284
862,34,34,5859416,5859965,566,5857751,5858534,876,5859410
863,36,36,5866025,5866608,600,5864560,5865348,671,5866019
864,38,38,5872735,5873351,632,5871370,5872162,567,5872729
865,30,30,5879844,5880327,499,5878179,5878976,862,5879838
866,6,6,5886703,5886786,100,5885005,5885790,907,5886697
867,2,2,5893462,5893479,34,5891814,5892604,852,5893456
868,36,36,5900371,5900954,600,5898623,5899418,947,5900365
869,38,38,5906981,5907597,633,5905449,5906232,742,5906974
870,42,42,5913757,5914440,699,5912259,5913046,705,5913751
871,2,2,5920366,5920383,34,5919068,5919860,500,5920360
872,28,28,5927359,5927808,466,5925877,5926674,678,5927352
873,10,10,5934368,5934518,166,5932703,5933488,874,5934362
874,50,50,5941077,5941893,833,5939512,5940302,769,5941071
875,60,60,5947853,5948836,999,5946322,5947116,731,5947847
876,6,6,5954463,5954546,100,5953148,5953930,527,5954457
877,4,4,5961539,5961588,66,5959957,5960744,788,5961532
878,46,46,5968115,5968864,766,5966766,5967558,550,5968108
879,44,44,5975090,5975806,733,5973575,5974372,712,5975084
880,8,8,5981933,5982050,133,5980401,5981186,740,5981926
881,20,20,5988709,5989025,333,5987211,5988000,703,5988703
882,52,52,5995552,5996401,865,5994020,5994814,731,5995545
883,32,32,6002527,6003044,533,6000829,6001628,893,6002521
884,10,10,6009370,6009520,166,6007655,6008442,922,6009364
885,10,10,6015796,6015946,167,6014464,6015256,533,6015789
886,48,48,6022672,6023455,799,6021274,6022070,596,6022666
887,52,52,6029498,6030347,866,6028100,6028884,608,6029492
888,26,26,6036557,6036973,433,6034909,6035698,853,6036551
889,32,32,6043466,6043982,533,6041718,6042512,948,6043460
890,54,54,6049909,6050792,899,6048528,6049326,577,6049903
891,54,54,6056985,6057867,899,6055353,6056140,838,6056978
892,52,52,6063611,6064460,866,6062163,6062954,651,6063605
893,52,52,6070437,6071286,866,6068972,6069768,663,6070431
894,6,6,6077546,6077629,100,6075798,6076582,958,6077540
895,12,12,6084039,6084222,200,6082607,6083396,636,6084032
896,40,40,6090898,6091548,666,6089417,6090210,682,6090892
897,50,50,6097907,6098723,833,6096226,6097024,877,6097901
898,20,20,6104800,6105116,333,6103052,6103838,956,6104794
899,8,8,6111576,6111692,133,6109861,6110652,918,6111570
900,6,6,6118369,6118452,99,6116670,6117466,896,6118362
901,52,52,6125061,6125910,866,6123496,6124280,775,6125055
902,2,2,6131970,6131987,34,6130306,6131094,871,6131965
903,22,22,6138613,6138963,367,6137115,6137908,699,6138607
904,34,34,6145356,6145905,566,6143924,6144722,627,6145349
905,34,34,6152115,6152665,566,6150750,6151536,573,6152109
906,4,4,6159024,6159074,67,6157559,6158350,668,6159018
907,42,42,6166034,6166716,699,6164369,6165164,864,6166028
908,54,54,6172793,6173675,899,6171195,6171978,809,6172787
909,26,26,6179552,6179968,433,6178004,6178792,754,6179546
910,58,58,6186278,6187227,966,6184813,6185606,666,6186272
911,14,14,6193121,6193337,233,6191622,6192420,694,6193114
912,32,32,6200047,6200563,532,6198448,6199234,806,6200040
913,26,26,6206889,6207305,433,6205258,6206048,835,6206883
914,12,12,6213798,6213982,200,6212067,6212862,930,6213792
915,14,14,6220541,6220758,233,6218893,6219676,859,6220535
916,8,8,6227284,6227400,133,6225702,6226490,787,6227277
917,56,56,6233943,6234859,933,6232511,6233304,632,6233936
918,22,22,6240753,6241102,366,6239321,6240118,628,6240746
919,44,44,6247545,6248261,733,6246147,6246932,607,6247539
920,40,40,6254621,6255270,666,6252956,6253746,869,6254615
921,48,48,6261230,6262013,799,6259765,6260560,664,6261224
922,22,22,6268206,6268556,366,6266591,6267374,826,6268200
923,52,52,6274882,6275731,866,6273400,6274188,687,6274875
924,2,2,6281791,6281808,34,6280210,6281002,783,6281785
925,8,8,6288767,6288884,133,6287019,6287816,945,6288761
926,32,32,6295243,6295760,533,6293845,6294630,607,6295237
927,44,44,6302069,6302785,733,6300654,6301444,619,6302063
928,46,46,6308795,6309545,766,6307464,6308258,531,6308789
929,42,42,6315954,6316637,700,6314289,6315072,876,6315948
930,36,36,6322847,6323430,599,6321099,6321886,955,6322841
931,16,16,6329423,6329673,266,6327908,6328700,717,6329417
932,56,56,6336266,6337181,932,6334717,6335514,745,6336259
933,10,10,6343191,6343341,167,6341543,6342328,857,6343185
934,22,22,6349768,6350117,366,6348353,6349142,620,6349762
935,58,58,6356893,6357842,966,6355162,6355956,931,6356887
936,42,42,6363453,6364135,699,6361971,6362770,676,6363446
937,18,18,6370196,6370479,299,6368797,6369584,605,6370189
938,32,32,6377188,6377704,533,6375606,6376398,783,6377181
939,52,52,6383814,6384663,866,6382416,6383212,596,6383808
940,36,36,6390590,6391173,599,6389242,6390026,558,6390584
941,8,8,6397449,6397566,134,6396051,6396840,603,6397443
942,52,52,6404342,6405191,866,6402860,6403654,681,6404335
943,38,38,6411384,6412000,633,6409669,6410468,910,6411378
944,2,2,6418077,6418094,33,6416495,6417282,788,6418070
945,6,6,6424920,6425003,99,6423305,6424096,818,6424914
946,56,56,6431696,6432611,932,6430114,6430910,779,6431689
947,54,54,6438655,6439537,899,6436940,6437724,925,6438649
948,14,14,6445198,6445414,233,6443749,6444538,653,6445191
949,58,58,6452173,6453122,966,6450558,6451352,815,6452167
950,34,34,6459099,6459649,566,6457368,6458166,927,6459093
951,50,50,6465609,6466425,832,6464194,6464980,623,6465603
952,24,24,6472518,6472901,400,6471003,6471794,718,6472512
953,18,18,6478328,6478611,300,6477812,6477825,496,6478321
954,18,18,6485221,6485504,300,6483856,6484639,576,6485215
955,4,4,6492330,6492380,66,6490665,6491453,871,6492324
956,50,50,6498906,6499722,832,6497474,6498267,632,6498899
957,2,2,6505782,6505799,33,6504284,6505081,695,6505776
958,26,26,6512608,6513024,433,6511109,6511895,706,6512601
959,12,12,6519534,6519717,199,6517919,6518709,819,6519528
960,20,20,6526226,6526543,333,6524728,6525523,697,6526220
961,6,6,6533102,6533186,100,6531554,6532337,759,6533096
962,60,60,6539995,6540977,999,6538363,6539151,837,6539988
963,14,14,6546022,6546238,233,6545173,6545182,833,6546015
964,60,60,6552598,6553580,999,6551199,6551996,595,6552591
965,2,2,6559457,6559474,33,6558025,6558810,640,6559450
966,36,36,6566183,6566766,599,6564835,6565624,553,6566177
967,40,40,6572959,6573608,666,6571644,6572438,515,6572953
968,8,8,6580218,6580334,133,6578453,6579252,960,6580212
969,6,6,6586994,6587077,100,6585279,6586066,922,6586988
970,42,42,6593786,6594469,700,6592088,6592880,900,6593780
971,50,50,6600446,6601262,832,6598898,6599694,746,6600440
972,52,52,6607438,6608287,866,6605724,6606508,925,6607433
973,16,16,6613931,6614181,267,6612533,6613322,603,6613925
974,60,60,6621040,6622023,999,6619342,6620136,898,6621034
975,40,40,6627517,6628166,666,6626151,6626950,560,6627510
976,48,48,6634326,6635108,799,6632977,6633764,555,6634319
977,6,6,6641535,6641618,100,6639787,6640578,951,6641529
978,12,12,6647928,6648111,200,6646596,6647392,529,6647921
979,38,38,6654737,6655353,633,6653422,6654206,525,6654731
980,16,16,6661929,6662179,267,6660231,6661020,903,6661923
981,24,24,6668389,6668772,400,6667040,6667834,548,6668382
982,6,6,6675431,6675515,100,6673850,6674648,777,6675425
983,56,56,6682424,6683339,932,6680676,6681462,956,6682418
984,28,28,6689266,6689716,467,6687485,6688276,984,6689260
985,36,36,6695843,6696425,599,6694294,6695090,746,6695836
986,56,56,6702902,6703817,932,6701120,6701904,991,6702895
987,56,56,6709361,6710277,933,6707929,6708718,636,6709354
988,52,52,6716487,6717336,866,6714739,6715532,949,6716481
989,40,40,6723230,6723879,665,6721548,6722346,877,6723223
990,10,10,6730122,6730272,167,6728374,6729160,956,6730116
991,42,42,6736831,6737514,700,6735183,6735974,851,6736825
992,30,30,6743757,6744240,500,6741993,6742788,964,6743752
993,58,58,6750184,6751133,965,6748818,6749602,575,6750177
994,24,24,6757359,6757742,400,6755628,6756416,937,6757353
995,60,60,6764119,6765101,998,6762437,6763230,882,6764112
996,18,18,6770678,6770961,300,6769246,6770044,627,6770671
997,58,58,6777820,6778769,966,6776072,6776858,956,6777814
998,48,48,6784213,6784996,800,6782882,6783672,535,6784207
999,34,34,6791322,6791872,566,6789691,6790486,830,6791316
1000,12,12,6798148,6798331,200,6796517,6797300,842,6798142
1001,40,40,6804741,6805390,666,6803326,6804114,621,6804735
1002,40,40,6811867,6812516,666,6810135,6810928,932,6811860
1003,50,50,6818609,6819425,833,6816945,6817742,862,6818604
1004,48,48,6825302,6826085,799,6823771,6824556,740,6825296
1005,38,38,6832295,6832911,632,6830580,6831370,919,6832289
1006,44,44,6838904,6839620,733,6837389,6838184,714,6838898
1007,52,52,6845780,6846629,866,6844215,6844998,776,6845774
1008,44,44,6852473,6853189,732,6851024,6851812,654,6852466
1009,32,32,6859215,6859732,533,6857834,6858626,583,6859209
1010,42,42,6865625,6866308,699,6864643,6864657,961,6865618
1011,56,56,6872218,6873134,932,6870686,6871471,740,6872211
1012,26,26,6878994,6879410,433,6877496,6878285,703,6878988
1013,16,16,6886036,6886286,267,6884305,6885099,931,6886030
1014,48,48,6892579,6893362,799,6891114,6891913,660,6892573
1015,2,2,6899705,6899722,33,6897940,6898727,972,6899699
1016,58,58,6906181,6907130,966,6904749,6905541,633,6906174
1017,26,26,6913157,6913573,433,6911559,6912355,796,6913151
1018,44,44,6919883,6920599,733,6918385,6919169,708,6919877
1019,60,60,6926709,6927691,999,6925194,6925983,720,6926703
1020,20,20,6933335,6933651,333,6932003,6932797,531,6933328
1021,44,44,6940494,6941210,733,6938813,6939611,877,6940488
1022,46,46,6947387,6948136,765,6945638,6946425,955,6947380
1023,40,40,6953796,6954446,666,6952448,6953239,551,6953790
1024,28,28,6960972,6961421,466,6959257,6960053,913,6960966
1025,26,26,6967615,6968031,432,6966083,6966867,741,6967608
1026,60,60,6974424,6975406,999,6972892,6973681,736,6974417
1027,38,38,6981083,6981699,633,6979702,6980495,582,6981077
1028,10,10,6988259,6988409,166,6986511,6987309,944,6988253
1029,60,60,6994735,6995717,999,6993337,6994123,606,6994729
1030,36,36,7001761,7002344,599,7000146,7000937,818,7001755
1031,36,36,7008537,7009120,599,7006955,7007751,779,7008530
1032,10,10,7015563,7015712,166,7013781,7014565,991,7015556
1033,54,54,7022089,7022971,899,7020591,7021379,704,7022083
1034,50,50,7028832,7029647,832,7027400,7028193,632,7028825
1035,8,8,7035941,7036057,133,7034209,7035007,927,7035934
1036,42,42,7042733,7043416,699,7041035,7041821,906,7042727
1037,28,28,7049459,7049909,466,7047844,7048635,818,7049453
1038,38,38,7056152,7056768,633,7054654,7055449,697,7056146
1039,40,40,7062761,7063411,666,7061480,7062263,492,7062755
1040,18,18,7070004,7070287,299,7068289,7069077,921,7069998
1041,54,54,7076763,7077645,899,7075098,7075891,866,7076757
1042,22,22,7083389,7083739,366,7081907,7082705,677,7083382
1043,18,18,7090248,7090531,300,7088733,7089519,723,7090242
1044,46,46,7097241,7097990,766,7095543,7096333,902,7097235
1045,18,18,7103834,7104117,299,7102352,7103147,680,7103827
1046,52,52,7110793,7111642,865,7109178,7109961,826,7110787
1047,50,50,7117685,7118501,833,7115987,7116775,904,7117679
1048,10,10,7124228,7124378,167,7122796,7123589,632,7124221
1049,58,58,7130921,7131870,966,7129606,7130403,512,7130915
1050,56,56,7136998,7137913,932,7136432,7136434,557,7136991
1051,2,2,7143840,7143857,34,7142458,7143248,585,7143833
1052,58,58,7150783,7151732,965,7149268,7150062,715,7150777
1053,6,6,7157509,7157592,100,7156077,7156876,626,7157502
1054,24,24,7164285,7164668,399,7162903,7163690,588,7164278
1055,60,60,7171094,7172076,999,7169712,7170504,583,7171087
1056,44,44,7178270,7178985,732,7176522,7177318,946,7178264
1057,14,14,7185112,7185329,233,7183347,7184132,974,7185106
1058,48,48,7191672,7192454,799,7190157,7190946,720,7191666
1059,50,50,7198315,7199130,832,7196966,7197760,548,7198308
1060,52,52,7205340,7206189,866,7203775,7204574,760,7205334
1061,22,22,7212249,7212599,367,7210601,7211388,855,7212243
1062,32,32,7218792,7219308,533,7217411,7218202,584,7218786
1063,58,58,7225668,7226617,966,7224220,7225016,646,7225662
1064,2,2,7232810,7232827,34,7231046,7231830,975,7232805
1065,38,38,7239520,7240136,633,7237855,7238644,870,7239514
1066,38,38,7245980,7246596,632,7244664,7245458,515,7245973
1067,48,48,7253105,7253888,799,7251474,7252272,827,7253099
1068,6,6,7259881,7259964,100,7258300,7259086,789,7259875
1069,32,32,7266424,7266940,533,7265109,7265900,518,7266418
1070,4,4,7273716,7273766,67,7271918,7272714,996,7273710
1071,28,28,7280126,7280575,466,7278744,7279528,591,7280119
1072,14,14,7287118,7287335,233,7285553,7286342,770,7287112
1073,16,16,7293911,7294161,266,7292363,7293156,749,7293905
1074,22,22,7300670,7301020,367,7299172,7299970,694,7300664
1075,50,50,7307646,7308462,832,7305998,7306784,856,7307640
1076,8,8,7314522,7314638,133,7312807,7313598,918,7314516
1077,26,26,7321398,7321814,433,7319616,7320412,979,7321391
1078,4,4,7327808,7327857,66,7326442,7327226,575,7327801
1079,42,42,7334867,7335549,699,7333252,7334040,821,7334861
1080,42,42,7341692,7342375,700,7340061,7340854,832,7341686
1081,54,54,7348369,7349251,899,7346870,7347668,694,7348362
1082,22,22,7355211,7355561,366,7353696,7354482,723,7355205
1083,28,28,7362287,7362736,466,7360505,7361296,984,7362280
1084,56,56,7368996,7369912,933,7367315,7368110,880,7368990
1085,32,32,7375722,7376238,533,7374141,7374924,792,7375716
1086,50,50,7382615,7383431,832,7380950,7381738,871,7382609
1087,42,42,7389174,7389857,700,7387759,7388552,616,7389168
1088,22,22,7396200,7396550,366,7394568,7395366,827,7396193
1089,12,12,7402909,7403093,200,7401394,7402180,723,7402903
1090,18,18,7409685,7409968,300,7408204,7408994,685,7409679
1091,46,46,7416794,7417544,766,7415013,7415808,980,7416788
1092,34,34,7423154,7423704,566,7421839,7422622,526,7423148
1093,36,36,7430296,7430879,600,7428648,7429436,854,7430290
1094,36,36,7436856,7437439,599,7435457,7436250,599,7436849
1095,52,52,7443982,7444831,865,7442267,7443064,912,7443976
1096,26,26,7450591,7451007,433,7449093,7449878,707,7450585
1097,26,26,7457667,7458083,433,7455902,7456692,969,7457661
1098,54,54,7464476,7465358,899,7462711,7463506,964,7464470
1099,50,50,7470902,7471718,833,7469537,7470320,576,7470896
1100,12,12,7478028,7478211,200,7476347,7477134,888,7478022
1101,4,4,7484638,7484687,66,7483156,7483948,683,7484631
1102,2,2,7491397,7491413,33,7489965,7490762,628,7491390
1103,8,8,7498323,7498439,133,7496791,7497576,740,7498316
1104,2,2,7505282,7505298,33,7503600,7504390,885,7505275
1105,8,8,7512074,7512191,134,7510410,7511204,865,7512069
1106,42,42,7518950,7519633,700,7517236,7518018,927,7518945
1107,12,12,7525343,7525527,200,7524045,7524832,505,7525337
1108,20,20,7532569,7532885,333,7530854,7531646,917,7532563
1109,8,8,7539162,7539278,133,7537663,7538460,695,7539155
1110,28,28,7545854,7546304,467,7544489,7545274,574,7545848
1111,60,60,7553063,7554046,999,7551299,7552088,970,7553058
1112,46,46,7559789,7560539,766,7558108,7558902,881,7559783
1113,30,30,7566665,7567148,500,7564917,7565716,943,7566659
1114,26,26,7573158,7573574,433,7571743,7572530,622,7573152
1115,48,48,7580334,7581116,799,7578552,7579344,983,7580327
1116,54,54,7586910,7587792,899,7585362,7586158,746,7586904
1117,30,30,7593619,7594102,500,7592188,7592972,641,7593613
1118,46,46,7600445,7601194,766,7598997,7599786,653,7600439
1119,24,24,7607171,7607554,400,7605806,7606600,565,7607165
1120,18,18,7613914,7614197,300,7612615,7613414,493,7613907
1121,32,32,7621189,7621706,533,7619441,7620228,955,7621183
1122,28,28,7627832,7628282,466,7626251,7627042,784,7627826
1123,24,24,7634642,7635024,399,7633060,7633856,779,7634635
1124,32,32,7641517,7642034,533,7639886,7640670,841,7641511
1125,6,6,7648460,7648543,100,7646695,7647484,970,7648454
1126,12,12,7654986,7655169,200,7653504,7654298,681,7654979
1127,20,20,7661862,7662178,333,7660314,7661112,744,7661856
1128,56,56,7668522,7669437,932,7667140,7667926,589,7668515
1129,40,40,7675597,7676246,666,7673949,7674740,851,7675591
1130,20,20,7682223,7682540,333,7680758,7681554,663,7682217
1131,22,22,7689299,7689649,366,7687584,7688368,925,7689293
1132,10,10,7695725,7695875,167,7694393,7695182,536,7695718
1133,58,58,7702968,7703916,965,7701203,7701996,966,7702962
1134,32,32,7709510,7710027,533,7708012,7708810,694,7709504
1135,18,18,7716353,7716636,300,7714838,7715624,723,7716347
1136,36,36,7723229,7723812,599,7721647,7722438,784,7723222
1137,2,2,7730105,7730121,33,7728457,7729252,847,7730099
1138,38,38,7736714,7737330,633,7735282,7736066,641,7736707
1139,34,34,7743790,7744339,566,7742092,7742880,904,7743784
1140,56,56,7750566,7751482,932,7748901,7749694,866,7750560
1141,4,4,7757409,7757458,66,7755710,7756508,894,7757402
1142,24,24,7764001,7764384,400,7762536,7763322,673,7763995
1143,42,42,7770861,7771543,699,7769346,7770136,719,7770855
1144,50,50,7777903,7778719,832,7776155,7776950,947,7777897
1145,54,54,7784446,7785328,899,7782981,7783764,676,7784440
1146,48,48,7791422,7792204,799,7789790,7790578,837,7791415
1147,18,18,7797931,7798214,300,7796599,7797392,532,7797924
1148,28,28,7805040,7805490,466,7803409,7804206,828,7805034
1149,44,44,7811983,7812699,732,7810235,7811020,957,7811977
1150,14,14,7818759,7818975,233,7817044,7817834,919,7818753
1151,38,38,7825418,7826034,633,7823853,7824648,764,7825412
1152,42,42,7832194,7832877,699,7830679,7831462,726,7832188
1153,30,30,7838904,7839386,499,7837488,7838276,621,7838897
1154,24,24,7845679,7846062,400,7844298,7845090,583,7845673
1155,58,58,7852422,7853371,966,7851107,7851904,512,7852416
1156,54,54,7859431,7860314,899,7857933,7858718,707,7859425
1157,46,46,7866474,7867223,765,7864742,7865532,935,7866467
1158,56,56,7873066,7873982,933,7871551,7872346,714,7873060
1159,50,50,7879859,7880675,833,7878377,7879160,692,7879852
1160,52,52,7886935,7887784,866,7885187,7885974,955,7886929
1161,44,44,7893361,7894077,733,7891996,7892788,567,7893355
1162,48,48,7900453,7901236,800,7898805,7899602,845,7900447
1163,20,20,7907296,7907612,333,7905631,7906416,874,7907290
1164,44,44,7914172,7914888,732,7912440,7913230,935,7914165
1165,48,48,7920565,7921347,799,7919250,7920044,515,7920559
1166,54,54,7927624,7928506,899,7926059,7926858,760,7927618
1167,28,28,7934333,7934783,467,7932885,7933672,655,7934327
1168,30,30,7941126,7941609,500,7939694,7940486,633,7941119
1169,24,24,7947802,7948185,400,7946504,7947300,496,7947796
1170,42,42,7955111,7955793,699,7953329,7954114,990,7955104
1171,48,48,7961754,7962536,799,7960139,7960928,820,7961748
1172,36,36,7968313,7968896,600,7966948,7967742,565,7968307
1173,24,24,7975073,7975455,399,7973757,7974556,510,7975066
1174,4,4,7982365,7982415,66,7980583,7981370,988,7982358
1175,56,56,7988724,7989640,933,7987393,7988184,534,7988718
1176,4,4,7995800,7995850,67,7994202,7994998,796,7995794
1177,40,40,8002443,8003092,666,8001028,8001812,625,8002437
1178,50,50,8009335,8010151,833,8007837,8008626,703,8009329
1179,34,34,8016245,8016794,566,8014646,8015440,798,8016238
1180,8,8,8023004,8023120,133,8021456,8022254,744,8022998
1181,32,32,8029896,8030413,533,8028282,8029068,823,8029891
1182,18,18,8036689,8036972,300,8035091,8035882,801,8036683
1183,52,52,8043448,8044298,866,8041900,8042696,746,8043442
1184,44,44,8050224,8050940,733,8048726,8049510,708,8050218
1185,50,50,8057267,8058083,832,8055535,8056324,936,8057260
1186,36,36,8064059,8064642,600,8062345,8063138,916,8064054
1187,14,14,8070835,8071052,234,8069154,8069952,877,8070829
1188,24,24,8077595,8077978,399,8075980,8076766,823,8077589
1189,26,26,8084537,8084953,433,8082789,8083580,951,8084531
1190,26,26,8091330,8091746,433,8089598,8090394,929,8091323
1191,16,16,8097773,8098023,266,8096424,8097208,558,8097766
1192,56,56,8104532,8105448,933,8103234,8104022,504,8104526
1193,6,6,8111824,8111908,100,8110043,8110836,982,8111818
1194,30,30,8118584,8119066,499,8116852,8117650,927,8118577
1195,30,30,8125027,8125509,499,8123678,8124464,556,8125020
1196,38,38,8132186,8132802,632,8130487,8131278,901,8132179
1197,2,2,8139012,8139028,33,8137297,8138092,914,8139006
1198,46,46,8145904,8146653,766,8144123,8144906,992,8145898
1199,10,10,8152564,8152713,166,8150932,8151720,837,8152557
1200,18,18,8159173,8159456,300,8157741,8158534,632,8159166
1201,50,50,8166182,8166998,833,8164551,8165348,828,8166176
1202,50,50,8173058,8173874,832,8171376,8172162,889,8173051
1203,46,46,8179884,8180633,766,8178186,8178976,902,8179878
1204,32,32,8186776,8187293,533,8184995,8185790,980,8186770
1205,38,38,8193286,8193902,633,8191821,8192604,676,8193280
1206,46,46,8200229,8200978,765,8198630,8199418,804,8200222
1207,40,40,8207021,8207670,666,8205440,8206232,783,8207015
1208,28,28,8213780,8214230,467,8212249,8213046,728,8213774
1209,56,56,8220806,8221722,933,8219075,8219860,940,8220800
1210,12,12,8227266,8227449,200,8225884,8226674,585,8227259
1211,52,52,8234441,8235290,866,8232693,8233488,947,8234435
1212,12,12,8241151,8241334,200,8239519,8240302,842,8241144
1213,2,2,8247744,8247760,33,8246329,8247116,622,8247738
1214,48,48,8254686,8255469,799,8253138,8253930,750,8254680
1215,44,44,8261429,8262145,732,8259947,8260744,678,8261422
1216,22,22,8268371,8268721,367,8266773,8267558,807,8268365
1217,18,18,8275081,8275364,299,8273582,8274372,702,8275074
1218,40,40,8282106,8282756,666,8280392,8281186,915,8282101
1219,32,32,8288949,8289465,533,8287218,8288000,943,8288943
1220,6,6,8295625,8295708,100,8294027,8294814,805,8295619
1221,12,12,8302551,8302734,200,8300836,8301628,917,8302545
1222,14,14,8308977,8309194,233,8307645,8308442,528,8308970
1223,24,24,8316236,8316619,400,8314471,8315256,974,8316230
1224,12,12,8322962,8323145,200,8321281,8322070,886,8322956
1225,60,60,8329405,8330387,999,8328090,8328884,515,8329399
1226,40,40,8336647,8337297,666,8334899,8335698,943,8336641
1227,32,32,8343323,8343839,533,8341725,8342512,805,8343317
1228,10,10,8349900,8350049,166,8348534,8349326,567,8349893
1229,26,26,8357108,8357525,433,8355344,8356140,963,8357103
1230,46,46,8363868,8364617,766,8362170,8362954,908,8363862
1231,42,42,8370744,8371426,699,8368979,8369768,970,8370738
1232,8,8,8377303,8377420,133,8375788,8376582,715,8377297
1233,8,8,8383929,8384046,134,8382597,8383396,526,8383922
1234,44,44,8390922,8391638,732,8389423,8390210,705,8390915
1235,12,12,8397981,8398164,200,8396233,8397024,951,8397975
1236,60,60,8404341,8405323,999,8403042,8403838,496,8404334
1237,18,18,8411499,8411783,300,8409868,8410652,841,8411493
1238,20,20,8418059,8418375,333,8416677,8417466,586,8418052
1239,48,48,8424868,8425651,799,8423486,8424280,581,8424861
1240,52,52,8431844,8432693,866,8430296,8431094,744,8431838
1241,30,30,8438603,8439086,500,8437122,8437908,689,8438597
1242,46,46,8445313,8446062,766,8443931,8444722,584,8445306
1243,38,38,8452455,8453071,633,8450740,8451536,913,8452449
1244,32,32,8459348,8459864,532,8457566,8458350,991,8459341
1245,48,48,8465841,8466623,799,8464376,8465164,671,8465835
1246,18,18,8472700,8472983,300,8471185,8471978,716,8472694
1247,42,42,8479476,8480158,699,8477994,8478792,677,8479469
1248,36,36,8486601,8487184,600,8484820,8485606,989,8486595
1249,26,26,8493211,8493627,433,8491629,8492420,784,8493204
1250,8,8,8500004,8500120,133,8498439,8499234,764,8499998
1251,42,42,8506646,8507329,700,8505265,8506048,592,8506640
1252,16,16,8513472,8513722,267,8512074,8512862,604,8513466
1253,6,6,8520465,8520548,100,8518883,8519676,782,8520458
1254,38,38,8527307,8527923,633,8525692,8526490,811,8527301
1255,14,14,8534067,8534283,233,8532518,8533304,756,8534060
1256,18,18,8540793,8541076,299,8539328,8540118,669,8540787
1257,14,14,8547918,8548135,233,8546137,8546932,980,8547912
1258,38,38,8554328,8554944,633,8552963,8553746,576,8554322
1259,22,22,8561504,8561853,366,8559772,8560560,937,8561497
1260,44,44,8568246,8568962,733,8566581,8567374,866,8568240
1261,58,58,8574889,8575838,966,8573391,8574188,695,8574883
1262,34,34,8581832,8582381,566,8580217,8581002,824,8581826
1263,56,56,8588391,8589307,932,8587026,8587816,569,8588385
1264,36,36,8595400,8595983,600,8593835,8594630,764,8595394
1265,38,38,8602376,8602992,633,8600661,8601444,926,8602370
1266,30,30,8609119,8609601,499,8607470,8608258,854,8609112
1267,48,48,8615795,8616577,799,8614280,8615072,717,8615789
1268,30,30,8622870,8623353,500,8621089,8621886,978,8622864
1269,44,44,8629663,8630379,733,8627915,8628700,957,8629657
1270,38,38,8636389,8637005,633,8634724,8635514,869,8636383
1271,60,60,8643015,8643997,999,8641533,8642328,680,8643008
1272,4,4,8650091,8650141,66,8648359,8649142,942,8650084
1273,30,30,8656684,8657167,499,8655169,8655956,722,8656678
1274,52,52,8663593,8664442,866,8661978,8662770,817,8663587
1275,46,46,8670386,8671135,765,8668787,8669584,795,8670379
1276,56,56,8677361,8678277,933,8675613,8676398,957,8677355
1277,32,32,8683921,8684437,533,8682422,8683212,702,8683914
1278,20,20,8690564,8690880,333,8689232,8690026,531,8690557
1279,26,26,8697573,8697989,433,8696041,8696840,726,8697566
1280,32,32,8704598,8705115,533,8702867,8703654,938,8704592
1281,2,2,8711358,8711374,33,8709676,8710468,883,8711351
1282,50,50,8718167,8718983,833,8716486,8717282,879,8718161
1283,46,46,8724677,8725426,766,8723311,8724096,574,8724670
1284,20,20,8731819,8732135,333,8730121,8730910,903,8731813
1285,4,4,8738495,8738545,67,8736930,8737724,765,8738489
1286,22,22,8745271,8745621,366,8743739,8744538,726,8745264
1287,48,48,8752014,8752796,799,8750565,8751352,655,8752007
1288,10,10,8758956,8759106,167,8757375,8758166,784,8758950
1289,6,6,8765782,8765865,100,8764184,8764980,796,8765776
1290,30,30,8772691,8773174,500,8771010,8771794,891,8772685
1291,4,4,8778468,8778518,67,8777819,8777825,636,8778461
1292,38,38,8785427,8786043,633,8783846,8784639,782,8785421
1293,52,52,8792387,8793236,865,8790655,8791453,927,8792380
1294,6,6,8798930,8799013,99,8797481,8798267,656,8798923
1295,46,46,8806022,8806771,766,8804290,8805081,934,8806015
1296,18,18,8812848,8813131,299,8811100,8811895,947,8812842
1297,32,32,8819441,8819957,532,8817926,8818709,726,8819435
1298,38,38,8826416,8827032,633,8824735,8825523,887,8826410
1299,30,30,8833092,8833575,500,8831544,8832337,749,8833086
1300,50,50,8839669,8840484,832,8838353,8839151,511,8839662
1301,46,46,8846628,8847377,766,8845179,8845965,656,8846621
1302,42,42,8853604,8854286,699,8851989,8852779,819,8853598
1303,60,60,8860479,8861462,999,8858798,8859593,880,8860473
1304,48,48,8867339,8868121,799,8865624,8866407,926,8867333
1305,4,4,8873732,8873782,66,8872433,8873221,504,8873725
1306,58,58,8880591,8881540,966,8879242,8880035,549,8880584
1307,20,20,8887533,8887850,333,8886052,8886849,678,8887527
1308,16,16,8894426,8894676,266,8892878,8893663,757,8894420
1309,14,14,8901302,8901518,233,8899687,8900477,819,8901296
1310,44,44,8907795,8908511,732,8906496,8907291,497,8907788
1311,18,18,8914637,8914920,300,8913322,8914105,526,8914631
1312,44,44,8921763,8922479,733,8920131,8920919,837,8921756
1313,4,4,8928556,8928606,66,8926941,8927733,817,8928550
1314,36,36,8935165,8935748,600,8933750,8934547,612,8935159
1315,54,54,8942274,8943157,899,8940576,8941361,907,8942268
1316,10,10,8948950,8949100,167,8947385,8948175,769,8948944
1317,56,56,8955526,8956442,933,8954195,8954989,531,8955520
1318,14,14,8962486,8962702,233,8961020,8961803,676,8962479
1319,32,32,8969395,8969911,533,8967830,8968617,772,8969389
1320,22,22,8976254,8976604,366,8974639,8975431,817,8976248
1321,32,32,8982814,8983330,532,8981448,8982245,562,8982807
1322,22,22,8989739,8990089,367,8988274,8989059,674,8989733
1323,28,28,8996565,8997015,466,8995084,8995873,686,8996559
1324,8,8,9003241,9003358,134,9001893,9002687,548,9003235
1325,60,60,9010417,9011399,999,9008702,9009501,910,9010411
1326,14,14,9016960,9017176,233,9015528,9016315,638,9016953
1327,22,22,9024036,9024385,366,9022337,9023129,900,9024029
1328,22,22,9030545,9030895,366,9029147,9029943,596,9030539
1329,30,30,9037521,9038004,499,9035973,9036757,758,9037515
1330,44,44,9044397,9045113,732,9042782,9043571,820,9044391
1331,60,60,9050906,9051889,999,9049591,9050385,515,9050900
1332,36,36,9058132,9058715,599,9056400,9057199,926,9058125
1333,30,30,9064941,9065424,500,9063226,9064013,922,9064935
1334,6,6,9071800,9071884,100,9070036,9070827,968,9071795
1335,28,28,9078543,9078993,466,9076845,9077641,896,9078537
1336,18,18,9085386,9085669,299,9083671,9084455,925,9085380
1337,28,28,9091812,9092262,466,9090480,9091269,536,9091805
1338,38,38,9098688,9099304,633,9097289,9098083,598,9098681
1339,34,34,9105664,9106213,566,9104099,9104897,761,9105658
1340,40,40,9112506,9113156,666,9110925,9111711,789,9112500
1341,46,46,9119415,9120165,766,9117734,9118525,884,9119409
1342,38,38,9126291,9126907,633,9124543,9125339,946,9126285
1343,60,60,9132851,9133833,999,9131369,9132153,691,9132844
1344,30,30,9139727,9140210,499,9138178,9138967,753,9139720
1345,36,36,9146703,9147285,599,9144988,9145781,916,9146697
1346,52,52,9153462,9154311,866,9151797,9152595,861,9153456
1347,10,10,9160404,9160554,167,9158623,9159409,989,9160398
1348,58,58,9167164,9168113,965,9165432,9166223,934,9167157
1349,8,8,9173740,9173856,133,9172242,9173037,697,9173734
1350,60,60,9180466,9181448,999,9179067,9179851,608,9180459
1351,34,34,9187525,9188074,566,9185877,9186665,854,9187519
1352,22,22,9194101,9194451,366,9192686,9193479,616,9194095
1353,26,26,9200960,9201377,433,9199495,9200293,661,9200954
1354,36,36,9207686,9208269,600,9206321,9207107,573,9207680
1355,18,18,9214579,9214862,300,9213131,9213921,652,9214573
1356,38,38,9220739,9221355,633,9219940,9219952,780,9220732
1357,10,10,9227315,9227465,167,9225983,9226766,542,9227308
1358,26,26,9234158,9234574,433,9232793,9233580,572,9234152
1359,20,20,9240984,9241300,333,9239602,9240394,583,9240977
1360,22,22,9248059,9248409,367,9246411,9247208,845,9248053
1361,18,18,9254985,9255268,300,9253237,9254022,957,9254979
1362,30,30,9261412,9261894,499,9260046,9260836,569,9261405
1363,54,54,9268421,9269303,899,9266856,9267650,765,9268415
1364,10,10,9275047,9275197,166,9273682,9274464,577,9275041
1365,52,52,9281873,9282722,865,9280491,9281278,588,9281866
1366,24,24,9288882,9289265,399,9287300,9288092,783,9288875
1367,44,44,9295525,9296240,732,9294109,9294906,612,9295518
1368,56,56,9302334,9303250,932,9300935,9301720,607,9302327
1369,12,12,9309326,9309509,200,9307745,9308534,786,9309320
1370,6,6,9316302,9316385,100,9314554,9315348,948,9316296
1371,10,10,9323028,9323178,167,9321363,9322162,860,9323022
1372,18,18,9329721,9330004,300,9328189,9328976,738,9329714
1373,28,28,9336613,9337063,467,9334998,9335790,817,9336607
1374,50,50,9343439,9344255,833,9341808,9342604,829,9343433
1375,48,48,9350199,9350981,799,9348634,9349418,775,9350193
1376,22,22,9357174,9357524,367,9355443,9356232,936,9357168
1377,52,52,9363801,9364650,865,9362252,9363046,748,9363794
1378,34,34,9370643,9371193,566,9369062,9369860,777,9370637
1379,50,50,9377336,9378152,832,9375887,9376674,655,9377329
1380,28,28,9384162,9384611,466,9382697,9383488,668,9384156
1381,14,14,9390838,9391054,233,9389506,9390302,529,9390831
1382,54,54,9397947,9398829,899,9396332,9397116,825,9397941
1383,12,12,9404490,9404673,200,9403141,9403930,553,9404483
1384,10,10,9411466,9411615,166,9409951,9410744,716,9411460
1385,36,36,9418275,9418858,599,9416760,9417558,711,9418269
1386,6,6,9425217,9425301,100,9423586,9424372,839,9425211
1387,52,52,9431777,9432626,866,9430395,9431186,584,9431770
1388,20,20,9438570,9438886,332,9437204,9438000,563,9438563
1389,30,30,9445479,9445961,499,9444030,9444814,658,9445472
1390,34,34,9452621,9453170,566,9450840,9451628,987,9452615
1391,12,12,9459264,9459447,200,9457649,9458442,816,9459258
1392,48,48,9466173,9466955,799,9464458,9465256,911,9466167
1393,18,18,9472866,9473149,299,9471284,9472070,789,9472859
1394,58,58,9479475,9480424,966,9478093,9478884,584,9479468
1395,2,2,9486434,9486451,34,9484903,9485698,730,9486428
1396,26,26,9493310,9493726,433,9491729,9492512,792,9493304
1397,40,40,9499920,9500569,666,9498538,9499326,587,9499913
1398,46,46,9507012,9507761,766,9505347,9506140,866,9507006
1399,14,14,9513738,9513954,233,9512156,9512954,777,9513731
1400,14,14,9520514,9520730,233,9518982,9519768,739,9520507
1401,42,42,9527090,9527773,699,9525792,9526582,502,9527084
1402,18,18,9534149,9534432,300,9532601,9533396,747,9534143
1403,50,50,9541008,9541824,833,9539427,9540210,792,9541002
1404,20,20,9547768,9548084,333,9546236,9547024,737,9547761
1405,58,58,9554810,9555759,966,9553045,9553838,966,9554804
1406,52,52,9561619,9562469,866,9559855,9560652,962,9561614
1407,16,16,9568429,9568678,266,9566681,9567466,957,9568423
1408,2,2,9574805,9574822,33,9573490,9574280,519,9574799
1409,48,48,9581781,9582563,799,9580299,9581094,680,9581774
1410,54,54,9588823,9589706,899,9587125,9587908,909,9588817
1411,20,20,9595350,9595666,333,9593934,9594722,621,9595343
1412,40,40,9602342,9602991,666,9600744,9601536,800,9602336
1413,50,50,9608885,9609701,832,9607553,9608350,528,9608878
1414,42,42,9616077,9616760,699,9614379,9615164,907,9616071
1415,38,38,9622836,9623452,633,9621188,9621978,852,9622830
1416,52,52,9629429,9630278,866,9627998,9628792,631,9629423
1417,56,56,9636305,9637221,933,9634823,9635606,692,9636298
1418,34,34,9643381,9643930,566,9641633,9642420,955,9643375
1419,58,58,9650040,9650989,966,9648442,9649234,800,9650034
1420,30,30,9656700,9657183,499,9655251,9656048,645,9656693
1421,56,56,9663692,9664608,932,9662077,9662862,824,9663686
1422,14,14,9670202,9670418,233,9668887,9669676,520,9670196
1423,30,30,9677344,9677827,499,9675696,9676490,848,9677338
1424,20,20,9683854,9684170,333,9682505,9683304,543,9683847
1425,14,14,9690763,9690979,233,9689331,9690118,638,9690756
1426,42,42,9697789,9698471,699,9696140,9696932,850,9697782
1427,26,26,9704714,9705131,433,9702950,9703746,963,9704709
1428,6,6,9711357,9711440,100,9709776,9710560,791,9711351
1429,40,40,9718033,9718683,666,9716585,9717374,653,9718027
1430,6,6,9724992,9725076,100,9723394,9724188,798,9724986
1431,58,58,9731802,9732751,965,9730203,9731002,793,9731795
1432,56,56,9738594,9739510,933,9737029,9737816,772,9738588
1433,24,24,9745304,9745687,399,9743839,9744630,668,9745298
1434,52,52,9752163,9753012,866,9750648,9751444,713,9752157
1435,52,52,9758839,9759688,866,9757474,9758258,575,9758833
1436,44,44,9765682,9766397,732,9764283,9765072,603,9765675
1437,20,20,9772707,9773024,333,9771092,9771886,815,9772701
1438,16,16,9779467,9779716,266,9777902,9778700,761,9779461
1439,38,38,9786143,9786759,632,9784728,9785514,623,9786137
1440,20,20,9793135,9793451,333,9791537,9792328,801,9793129
1441,48,48,9799661,9800444,800,9798346,9799142,513,9799655
1442,2,2,9806554,9806571,33,9805172,9805956,591,9806547
1443,12,12,9813480,9813663,200,9811981,9812770,703,9813473
1444,26,26,9820472,9820888,433,9818791,9819584,882,9820466
1445,6,6,9827182,9827265,99,9825600,9826398,777,9827175
1446,58,58,9834057,9835006,966,9832426,9833212,839,9834051
1447,58,58,9840850,9841799,966,9839235,9840026,818,9840844
1448,46,46,9847609,9848359,766,9846044,9846840,763,9847603
1449,10,10,9854469,9854619,166,9852870,9853654,808,9854462
1450,30,30,9861095,9861578,499,9859680,9860468,621,9861089
1451,2,2,9867788,9867804,33,9866489,9867282,499,9867781
1452,52,52,9874647,9875496,866,9873298,9874096,544,9874640
1453,30,30,9881656,9882139,499,9880124,9880910,739,9881649
1454,30,30,9888232,9888715,500,9886933,9887724,501,9888225
1455,14,14,9895274,9895491,234,9893743,9894538,730,9895268
1456,22,22,9901917,9902267,367,9900569,9901352,559,9901911
1457,46,46,9909060,9909809,765,9907378,9908166,887,9909053
1458,54,54,9915652,9916535,899,9914187,9914980,666,9915646
1459,32,32,9922378,9922895,533,9920997,9921794,578,9922372
1460,26,26,9929487,9929904,433,9927822,9928608,873,9929481
1461,26,26,9936363,9936779,433,9934632,9935422,935,9936357
1462,50,50,9943189,9944005,833,9941441,9942236,947,9943183
1463,44,44,9949732,9950448,733,9948267,9949050,676,9949726
1464,52,52,9956541,9957390,866,9955076,9955864,671,9956535
1465,2,2,9963284,9963301,33,9961886,9962678,600,9963278
1466,6,6,9970326,9970410,100,9968695,9969492,828,9970320
1467,18,18,9976919,9977202,300,9975521,9976306,607,9976913
1468,24,24,9983945,9984328,400,9982330,9983120,819,9983939
1469,58,58,9990887,9991836,966,9989139,9989934,947,9990881
1470,14,14,9997347,9997564,233,9995965,9996748,592,9997340
1471,8,8,10004090,10004206,133,10002775,10003562,522,10004084
1472,38,38,10011082,10011698,633,10009584,10010376,700,10011076
1473,30,30,10018008,10018491,500,10016393,10017190,812,10018002
1474,28,28,10024801,10025250,466,10023219,10024004,790,10024794
1475,42,42,10031577,10032259,699,10030028,10030818,752,10031570
1476,44,44,10038619,10039335,733,10036838,10037632,981,10038613
1477,42,42,10045212,10045895,699,10043664,10044446,760,10045206
1478,32,32,10051788,10052304,533,10050473,10051260,522,10051782
1479,56,56,10058781,10059696,932,10057282,10058074,700,10058774
1480,50,50,10065540,10066356,832,10064091,10064888,645,10065533
1481,44,44,10072582,10073298,733,10070917,10071702,874,10072576
1482,52,52,10079425,10080274,866,10077727,10078516,903,10079419
1483,44,44,10085934,10086650,733,10084536,10085330,598,10085928
1484,60,60,10093110,10094092,999,10091345,10092144,960,10093104
1485,34,34,10099620,10100169,566,10098171,10098958,655,10099613
1486,50,50,10106462,10107278,833,10104980,10105772,683,10106455
1487,10,10,10113155,10113305,166,10111790,10112586,563,10113149
1488,38,38,10119931,10120547,633,10118616,10119400,525,10119925
1489,42,42,10127156,10127839,700,10125425,10126214,936,10127150
1490,26,26,10133999,10134415,433,10132234,10133028,965,10133993
1491,10,10,10140692,10140842,166,10139044,10139842,844,10140686
1492,58,58,10147168,10148117,966,10145869,10146656,505,10147161
1493,34,34,10154044,10154593,566,10152679,10153470,568,10154038
1494,58,58,10161153,10162102,966,10159488,10160284,863,10161147
1495,54,54,10167696,10168578,899,10166314,10167098,591,10167689
1496,18,18,10174888,10175171,300,10173123,10173912,970,10174882
1497,44,44,10181431,10182147,732,10179933,10180726,699,10181425
1498,56,56,10188207,10189123,932,10186742,10187540,661,10188201
1499,42,42,10195133,10195815,699,10193568,10194354,773,10195127
1500,44,44,10202142,10202858,732,10200377,10201168,968,10202136
1501,32,32,10208768,10209284,533,10207186,10207982,779,10208761
1502,4,4,10215677,10215727,67,10214012,10214796,875,10215671
1503,54,54,10222337,10223219,899,10220822,10221610,721,10222331
1504,8,8,10229212,10229329,134,10227631,10228424,782,10229206
1505,36,36,10236122,10236704,599,10234440,10235238,877,10236115
1506,16,16,10242781,10243031,266,10241266,10242052,723,10242775
1507,32,32,10249574,10250090,532,10248075,10248866,701,10249567
1508,52,52,10256383,10257232,866,10254885,10255680,697,10256377
1509,44,44,10263475,10264191,733,10261711,10262494,976,10263470
1510,6,6,10270068,10270151,100,10268520,10269308,754,10270062
1511,60,60,10277094,10278076,999,10275329,10276122,966,10277088
1512,40,40,10283670,10284319,666,10282138,10282936,727,10283663
1513,22,22,10290596,10290946,366,10288964,10289750,839,10290589
1514,28,28,10297072,10297522,466,10295774,10296564,502,10297066
1515,48,48,10303915,10304697,799,10302583,10303378,530,10303908
1516,16,16,10311107,10311357,266,10309409,10310192,909,10311101
1517,14,14,10317800,10318016,233,10316218,10317006,787,10317793
1518,20,20,10324459,10324776,333,10323027,10323820,632,10324452
1519,22,22,10331235,10331585,366,10329837,10330634,595,10331229
1520,56,56,10338411,10339326,932,10336663,10337448,957,10338405
1521,4,4,10344771,10344820,66,10343472,10344262,502,10344764
1522,38,38,10351813,10352429,633,10350281,10351076,730,10351806
1523,18,18,10358772,10359055,300,10357107,10357890,876,10358766
1524,12,12,10365282,10365465,199,10363916,10364704,571,10365275
1525,46,46,10372457,10373206,766,10370726,10371518,933,10372451
1526,28,28,10379300,10379749,466,10377535,10378332,962,10379294
1527,26,26,10385676,10386092,433,10384361,10385146,524,10385670
1528,28,28,10392852,10393301,466,10391170,10391960,885,10392845
1529,18,18,10399278,10399561,300,10397980,10398774,498,10399272
1530,58,58,10406154,10407103,966,10404805,10405588,559,10406147
1531,36,36,10413047,10413629,599,10411615,10412402,638,10413040
1532,22,22,10419756,10420106,366,10418424,10419216,533,10419749
1533,12,12,10426632,10426815,200,10425233,10426030,595,10426625
1534,20,20,10433491,10433807,333,10432059,10432844,640,10433484
1535,42,42,10440450,10441133,699,10438869,10439658,786,10440444
1536,60,60,10447243,10448225,999,10445678,10446472,765,10447237
1537,4,4,10454202,10454252,67,10452487,10453286,910,10454196
1538,34,34,10460145,10460695,567,10459313,10459317,821,10460138
1539,2,2,10467021,10467038,34,10465340,10466131,884,10467015
1540,22,22,10473614,10473964,366,10472149,10472945,663,10473608
1541,38,38,10480607,10481223,632,10478975,10479759,841,10480600
1542,8,8,10487299,10487416,134,10485784,10486573,720,10487293
1543,4,4,10494042,10494092,67,10492594,10493387,649,10494036
1544,30,30,10500718,10501201,500,10499403,10500201,511,10500712
1545,16,16,10507627,10507877,267,10506229,10507015,606,10507621
1546,46,46,10514337,10515086,766,10513038,10513829,501,10514330
1547,30,30,10521146,10521629,499,10519847,10520643,496,10521139
1548,32,32,10528272,10528788,532,10526673,10527457,808,10528265
1549,40,40,10535197,10535847,666,10533483,10534271,921,10535192
1550,54,54,10542057,10542939,899,10540292,10541085,966,10542051
1551,26,26,10548666,10549082,433,10547101,10547899,761,10548660
1552,46,46,10555309,10556058,766,10553927,10554713,589,10555302
1553,12,12,10562318,10562501,200,10560736,10561527,784,10562311
1554,14,14,10568977,10569194,234,10567546,10568341,630,10568971
1555,20,20,10575704,10576020,333,10574372,10575155,542,10575697
1556,6,6,10582646,10582729,100,10581181,10581969,671,10582640
1557,44,44,10589555,10590271,733,10587990,10588783,766,10589549
1558,8,8,10596315,10596431,133,10594799,10595597,711,10596308
1559,52,52,10603091,10603940,865,10601625,10602411,673,10603084
1560,50,50,10609916,10610732,833,10608435,10609225,685,10609910
1561,8,8,10616642,10616759,134,10615244,10616039,597,10616636
1562,2,2,10623835,10623851,33,10622070,10622853,976,10623829
1563,50,50,10630511,10631327,832,10628879,10629667,837,10630504
1564,18,18,10637253,10637537,300,10635689,10636481,767,10637248
1565,44,44,10644063,10644779,732,10642498,10643295,762,10644057
1566,32,32,10651005,10651521,533,10649324,10650109,890,10650999
1567,8,8,10657448,10657565,133,10656133,10656923,519,10657442
1568,2,2,10664507,10664524,34,10662942,10663737,764,10664501
1569,60,60,10671200,10672182,999,10669768,10670551,642,10671193
1570,24,24,10678342,10678725,400,10676578,10677365,972,10678337
1571,6,6,10684835,10684918,100,10683387,10684179,650,10684829
1572,20,20,10691511,10691828,333,10690196,10690993,512,10691505
1573,28,28,10698587,10699037,466,10697022,10697807,774,10698581
1574,18,18,10705579,10705862,300,10703831,10704621,952,10705573
1575,28,28,10712039,10712489,466,10710641,10711435,598,10712033
1576,26,26,10718982,10719398,432,10717467,10718249,727,10718976
1577,8,8,10725807,10725924,134,10724276,10725063,738,10725801
1578,56,56,10732866,10733782,933,10731085,10731877,983,10732860
1579,40,40,10739243,10739892,666,10737894,10738691,545,10739236
1580,6,6,10746052,10746135,100,10744720,10745505,540,10746045
1581,52,52,10753078,10753927,866,10751530,10752319,753,10753072
1582,58,58,10759821,10760770,965,10758339,10759133,681,10759814
1583,52,52,10766813,10767662,866,10765148,10765947,860,10766807
1584,4,4,10773606,10773656,66,10771974,10772761,838,10773599
1585,56,56,10780398,10781314,933,10778783,10779575,817,10780392
1586,18,18,10786958,10787241,300,10785593,10786389,563,10786952
1587,60,60,10793751,10794733,998,10792419,10793203,541,10793744
1588,4,4,10800743,10800793,67,10799228,10800017,720,10800737
1589,16,16,10807819,10808068,266,10806037,10806831,981,10807812
1590,60,60,10814378,10815360,999,10812846,10813645,726,10814371
1591,42,42,10821337,10822020,700,10819672,10820459,872,10821331
1592,14,14,10827780,10827997,233,10826482,10827273,501,10827774
1593,32,32,10834590,10835106,532,10833291,10834087,496,10834583
1594,24,24,10841832,10842215,399,10840117,10840901,925,10841826
1595,36,36,10848641,10849224,599,10846926,10847715,920,10848635
1596,48,48,10855067,10855850,800,10853735,10854529,531,10855060
1597,40,40,10862010,10862659,666,10860545,10861343,661,10862004
1598,36,36,10868753,10869335,599,10867371,10868157,589,10868746
1599,44,44,10875578,10876294,733,10874180,10874971,601,10875572
1600,2,2,10882288,10882305,33,10880989,10881785,496,10882281
1601,38,38,10889380,10889996,633,10887815,10888599,775,10889374
1602,16,16,10896406,10896656,266,10894624,10895413,986,10896399
1603,50,50,10902916,10903731,832,10901434,10902227,682,10902909
1604,56,56,10909575,10910491,932,10908243,10909041,527,10909568
1605,58,58,10916800,10917749,966,10915069,10915855,939,10916794
1606,38,38,10923543,10924159,633,10921878,10922669,868,10923537
1607,4,4,10930069,10930119,67,10928688,10929483,580,10930063
1608,38,38,10936912,10937528,633,10935513,10936297,608,10936905
1609,50,50,10943771,10944587,833,10942323,10943111,654,10943765
1610,14,14,10950897,10951113,233,10949132,10949925,966,10950891
1611,46,46,10957556,10958305,766,10955941,10956739,811,10957550
1612,42,42,10964349,10965031,699,10962767,10963553,789,10964342
1613,50,50,10971075,10971891,832,10969577,10970367,702,10971069
1614,30,30,10977884,10978367,500,10976386,10977181,697,10977878
1615,32,32,10984910,10985426,533,10983212,10983995,909,10984904
1616,38,38,10991753,10992369,632,10990021,10990809,937,10991746
1617,46,46,10998545,10999294,766,10996830,10997623,916,10998539
1618,36,36,11005305,11005887,599,11003640,11004437,862,11005299
1619,2,2,11011748,11011764,33,11010466,11011251,490,11011741
1620,14,14,11018773,11018990,233,11017275,11018065,702,11018767
1621,14,14,11025816,11026032,233,11024084,11024879,930,11025809
1622,48,48,11032392,11033174,799,11030910,11031693,692,11032385
1623,4,4,11039101,11039151,67,11037719,11038507,587,11039094
1624,20,20,11045861,11046177,333,11044529,11045321,533,11045854
1625,48,48,11053119,11053902,799,11051338,11052135,978,11053113
1626,36,36,11059696,11060278,599,11058164,11058949,740,11059689
1627,60,60,11066521,11067504,999,11064973,11065763,752,11066515
1628,4,4,11073497,11073547,67,11071782,11072577,914,11073491
1629,24,24,11079990,11080373,400,11078608,11079391,592,11079983
1630,38,38,11086733,11087349,633,11085418,11086205,522,11086727
1631,34,34,11093925,11094475,566,11092227,11093019,900,11093919
1632,12,12,11100684,11100868,200,11099036,11099833,845,11100678
1633,6,6,11107527,11107610,100,11105862,11106647,874,11107521
1634,50,50,11114420,11115235,832,11112671,11113461,952,11114413
1635,28,28,11121096,11121545,466,11119481,11120275,815,11121090
1636,12,12,11127755,11127938,200,11126290,11127089,660,11127749
1637,20,20,11134781,11135097,333,11133116,11133903,872,11134775
1638,58,58,11141474,11142423,965,11139925,11140717,750,11141467
1639,40,40,11148383,11149032,666,11146735,11147531,846,11148377
1640,12,12,11155209,11155392,199,11153560,11154345,857,11155202
1641,16,16,11161652,11161901,266,11160370,11161159,486,11161645
1642,52,52,11168561,11169410,866,11167179,11167973,581,11168554
1643,34,34,11175304,11175853,566,11173988,11174787,510,11175297
1644,4,4,11182429,11182479,67,11180814,11181601,822,11182423
1645,22,22,11189139,11189488,366,11187624,11188415,718,11189133
1646,10,10,11195948,11196098,166,11194433,11195229,713,11195942
1647,12,12,11202857,11203040,200,11201259,11202043,808,11202851
1648,4,4,11209500,11209550,66,11208068,11208857,636,11209493
1649,14,14,11216193,11216409,233,11214877,11215671,515,11216186
1650,12,12,11223385,11223568,200,11221687,11222485,894,11223379
1651,10,10,11229978,11230127,166,11228513,11229299,673,11229972
1652,6,6,11236920,11237003,100,11235322,11236113,801,11236914
1653,2,2,11243563,11243580,33,11242131,11242927,629,11243556
1654,46,46,11250689,11251438,765,11248957,11249741,941,11250682
1655,24,24,11257065,11257448,400,11255766,11256555,503,11257058
1656,12,12,11264024,11264207,200,11262576,11263369,649,11264018
1657,6,6,11271116,11271200,100,11269385,11270183,927,11271110
1658,42,42,11277792,11278475,700,11276211,11276997,789,11277786
1659,50,50,11284419,11285234,832,11283020,11283811,601,11284412
1660,8,8,11291544,11291661,133,11289829,11290625,913,11291538
1661,42,42,11298320,11299003,699,11296655,11297439,875,11298314
1662,14,14,11304780,11304996,233,11303465,11304253,521,11304774
1663,28,28,11311656,11312105,466,11310274,11311067,582,11311649
1664,38,38,11318632,11319248,632,11317083,11317881,744,11318625
1665,48,48,11325408,11326190,799,11323909,11324695,706,11325401
1666,38,38,11332400,11333016,633,11330718,11331509,884,11332393
1667,22,22,11339026,11339376,366,11337528,11338323,697,11339020
1668,6,6,11345919,11346002,100,11344354,11345137,776,11345913
1669,24,24,11352595,11352978,399,11351163,11351951,637,11352588
1670,58,58,11359570,11360519,966,11357972,11358765,799,11359564
1671,6,6,11366563,11366646,100,11364782,11365579,978,11366557
1672,2,2,11373306,11373322,33,11371607,11372393,906,11373299
1673,36,36,11379799,11380381,599,11378417,11379207,585,11379792
1674,48,48,11386558,11387340,799,11385226,11386021,530,11386551
1675,10,10,11393584,11393733,166,11392052,11392835,742,11393577
1676,12,12,11400293,11400476,200,11398861,11399649,637,11400286
1677,18,18,11407435,11407718,300,11405671,11406463,967,11407430
1678,36,36,11414028,11414611,599,11412480,11413277,745,11414022
1679,8,8,11420937,11421054,134,11419306,11420091,840,11420931
1680,12,12,11427447,11427630,200,11426115,11426905,535,11427440
1681,58,58,11434639,11435588,966,11432924,11433719,914,11434633
1682,30,30,11441448,11441931,500,11439750,11440533,909,11441442
1683,58,58,11448241,11449190,966,11446560,11447347,888,11448235
1684,56,56,11454950,11455866,933,11453369,11454161,783,11454944
1685,60,60,11461943,11462925,999,11460178,11460975,962,11461937
1686,56,56,11468336,11469252,932,11467004,11467789,540,11468329
1687,26,26,11475478,11475894,433,11473813,11474603,869,11475472
1688,52,52,11482221,11483070,866,11480623,11481417,798,11482215
1689,18,18,11489130,11489413,300,11487449,11488231,893,11489124
1690,28,28,11495906,11496356,466,11494258,11495045,855,11495900
1691,52,52,11502516,11503365,865,11501067,11501859,650,11502509
1692,50,50,11509558,11510374,832,11507876,11508673,878,11509551
1693,18,18,11516234,11516517,300,11514702,11515487,740,11516227
1694,20,20,11523027,11523343,333,11521512,11522301,720,11523021
1695,16,16,11529886,11530136,266,11528321,11529115,765,11529880
1696,54,54,11536579,11537461,899,11535130,11535929,643,11536572
1697,10,10,11543521,11543671,167,11541956,11542743,772,11543515
1698,16,16,11550181,11550430,266,11548765,11549557,617,11550174
1699,58,58,11557006,11557955,966,11555575,11556371,629,11557000
1700,6,6,11563966,11564049,100,11562401,11563185,775,11563960
1701,30,30,11570858,11571341,500,11569210,11569999,853,11570852
1702,28,28,11577601,11578050,466,11576019,11576813,781,11577594
1703,12,12,11584577,11584760,199,11582828,11583627,943,11584570
1704,20,20,11591136,11591452,333,11589654,11590441,688,11591129
1705,60,60,11598228,11599211,999,11596464,11597255,968,11598223
1706,32,32,11604771,11605287,533,11603273,11604069,696,11604765
1707,10,10,11611647,11611797,167,11610099,11610883,758,11611641
1708,28,28,11618240,11618690,466,11616908,11617697,536,11618233
1709,54,54,11625066,11625948,899,11623717,11624511,548,11625059
1710,30,30,11631859,11632341,499,11630527,11631325,527,11631852
1711,52,52,11639084,11639933,866,11637353,11638139,939,11639078
1712,10,10,11645577,11645727,167,11644162,11644953,618,11645571
1713,30,30,11652270,11652753,499,11650971,11651767,496,11652263
1714,46,46,11659129,11659878,766,11657797,11658581,541,11659122
1715,22,22,11666171,11666521,367,11664607,11665395,771,11666166
1716,28,28,11672931,11673380,466,11671416,11672209,716,11672925
1717,26,26,11680006,11680423,433,11678225,11679023,977,11680000
1718,34,34,11686533,11687082,566,11685051,11685837,689,11686526
1719,24,24,11693459,11693841,399,11691860,11692651,801,11693452
1720,16,16,11699968,11700218,267,11698670,11699465,497,11699962
1721,52,52,11707244,11708093,865,11705496,11706279,959,11707238
1722,6,6,11713620,11713703,100,11712305,11713093,521,11713614
1723,6,6,11720862,11720945,100,11719114,11719907,949,11720856
1724,44,44,11727405,11728121,733,11725923,11726721,677,11727398
1725,48,48,11734198,11734980,799,11732749,11733535,656,11734191
1726,52,52,11741140,11741989,866,11739559,11740349,785,11741134
1727,8,8,11747949,11748066,134,11746368,11747163,780,11747943
1728,60,60,11754775,11755758,999,11753194,11753977,792,11754769
1729,34,34,11761568,11762117,566,11760003,11760791,771,11761562
1730,2,2,11768228,11768244,33,11766812,11767605,616,11768221
1731,16,16,11775253,11775503,267,11773622,11774419,828,11775247
1732,34,34,11782162,11782712,566,11780448,11781233,924,11782157
1733,16,16,11788955,11789205,266,11787257,11788047,902,11788949
1734,46,46,11795831,11796580,766,11794066,11794861,964,11795825
1735,54,54,11802557,11803439,899,11800892,11801675,876,11802551
1736,58,58,11809233,11810182,966,11807701,11808489,737,11809226
1737,38,38,11816009,11816625,633,11814511,11815303,700,11816003
1738,42,42,11822635,11823318,699,11821320,11822117,512,11822629
1739,30,30,11829528,11830011,499,11828146,11828931,590,11829521
1740,60,60,11836537,11837519,999,11834955,11835745,785,11836530
1741,52,52,11843429,11844278,866,11841764,11842559,864,11843423
1742,4,4,11850239,11850289,66,11848590,11849373,859,11850232
1743,4,4,11856848,11856898,67,11855400,11856187,655,11856842
1744,56,56,11863841,11864756,932,11862209,11863001,833,11863834
1745,32,32,11870550,11871066,533,11869018,11869815,728,11870543
1746,10,10,11877459,11877609,167,11875844,11876629,824,11877453
1747,50,50,11884402,11885217,832,11882653,11883443,952,11884395
1748,12,12,11890761,11890944,200,11889463,11890257,498,11890755
1749,24,24,11897587,11897970,400,11896272,11897071,510,11897581
1750,38,38,11904663,11905279,633,11903098,11903885,772,11904657
1751,40,40,11911589,11912238,666,11909907,11910699,883,11911582
1752,10,10,11918331,11918481,167,11916717,11917513,813,11918326
1753,4,4,11925274,11925324,67,11923542,11924327,940,11925267
1754,40,40,11931834,11932483,665,11930352,11931141,686,11931827
1755,50,50,11938776,11939592,832,11937161,11937955,815,11938770
1756,54,54,11945652,11946534,899,11943970,11944769,876,11945645
1757,24,24,11951412,11951795,400,11950796,11950800,605,11951405
1758,36,36,11958288,11958871,600,11956823,11957614,668,11958282
1759,16,16,11965114,11965364,266,11963632,11964428,679,11965107
1760,8,8,11971890,11972007,133,11970458,11971242,641,11971883
1761,56,56,11978716,11979632,932,11977268,11978056,654,11978710
1762,58,58,11985692,11986641,965,11984077,11984870,816,11985686
1763,14,14,11992251,11992468,233,11990886,11991684,561,11992245
1764,50,50,11999493,12000309,833,11997712,11998498,989,11999487
1765,36,36,12006053,12006636,599,12004521,12005312,734,12006046
1766,36,36,12013079,12013661,599,12011331,12012126,947,12013073
1767,40,40,12019488,12020138,666,12018157,12018940,542,12019482
1768,14,14,12026448,12026664,233,12024966,12025754,687,12026441
1769,6,6,12033540,12033623,100,12031775,12032568,966,12033534
1770,14,14,12040333,12040549,233,12038584,12039382,944,12040326
1771,6,6,12046992,12047075,100,12045410,12046196,789,12046985
1772,10,10,12053901,12054051,167,12052220,12053010,885,12053895
1773,54,54,12060627,12061510,899,12059029,12059824,797,12060621
1774,2,2,12067586,12067603,34,12065855,12066638,942,12067580
1775,52,52,12074113,12074962,865,12072664,12073452,654,12074106
1776,50,50,12080772,12081588,832,12079473,12080266,499,12080765
1777,22,22,12087981,12088331,366,12086283,12087080,895,12087975
1778,18,18,12094790,12095073,300,12093109,12093894,890,12094784
1779,46,46,12101583,12102332,766,12099918,12100708,869,12101577
1780,46,46,12108442,12109191,766,12106727,12107522,914,12108436
1781,56,56,12114968,12115884,933,12113553,12114336,626,12114962
1782,2,2,12122061,12122077,33,12120362,12121150,904,12122054
1783,36,36,12128853,12129436,600,12127172,12127964,883,12128847
1784,30,30,12135646,12136129,499,12133981,12134778,862,12135640
1785,32,32,12142472,12142988,533,12140807,12141592,874,12142466
1786,18,18,12148998,12149281,300,12147616,12148406,585,12148991
1787,6,6,12156157,12156240,100,12154426,12155220,931,12156151
1788,4,4,12162717,12162767,66,12161251,12162034,676,12162710
1789,20,20,12169626,12169942,333,12168061,12168848,772,12169620
1790,60,60,12176602,12177584,998,12174870,12175662,933,12176595
1791,18,18,12183427,12183710,300,12181679,12182476,945,12183421
1792,24,24,12190070,12190453,400,12188505,12189290,774,12190064
1793,4,4,12196996,12197046,67,12195315,12196104,886,12196990
1794,16,16,12203589,12203839,266,12202124,12202918,665,12203583
1795,54,54,12210548,12211430,899,12208933,12209732,810,12210542
1796,30,30,12217407,12217890,500,12215759,12216546,855,12217401
1797,44,44,12223917,12224633,732,12222568,12223360,550,12223910
1798,26,26,12231159,12231575,433,12229378,12230174,979,12231153
1799,54,54,12237602,12238484,899,12236204,12236988,608,12237596
1800,36,36,12244345,12244927,599,12243013,12243802,536,12244338
1801,12,12,12251154,12251337,200,12249822,12250616,531,12251147
1802,56,56,12258163,12259079,932,12256631,12257430,726,12258156
1803,48,48,12264823,12265605,799,12263457,12264244,572,12264816
1804,14,14,12271965,12272181,233,12270267,12271058,901,12271959
1805,16,16,12278691,12278941,266,12277076,12277872,813,12278685
1806,30,30,12285367,12285850,499,12283902,12284686,675,12285361
1807,18,18,12292393,12292676,299,12290711,12291500,886,12292386
1808,54,54,12298886,12299768,899,12297520,12298314,565,12298879
1809,8,8,12306045,12306161,133,12304330,12305128,911,12306039
1810,36,36,12312737,12313320,600,12311156,12311942,789,12312731
1811,56,56,12319513,12320429,933,12317965,12318756,751,12319507
1812,54,54,12326273,12327155,899,12324774,12325570,696,12326266
1813,12,12,12333148,12333332,200,12331600,12332384,758,12333142
1814,38,38,12340008,12340624,632,12338409,12339198,803,12340001
1815,56,56,12346950,12347866,933,12345219,12346012,932,12346944
1816,6,6,12353743,12353826,100,12352028,12352826,911,12353737
1817,22,22,12360552,12360902,366,12358854,12359640,906,12360546
1818,16,16,12366962,12367212,266,12365663,12366454,501,12366955
1819,50,50,12374054,12374870,833,12372473,12373268,780,12374048
1820,8,8,12379798,12379914,133,12379298,12379299,491,12379790
1821,26,26,12386890,12387306,433,12385325,12386113,771,12386884
1822,18,18,12393566,12393849,300,12392135,12392927,633,12393560
1823,34,34,12400642,12401191,566,12398944,12399741,895,12400636
1824,8,8,12407535,12407651,133,12405770,12406555,974,12407529
1825,16,16,12414027,12414277,267,12412579,12413369,652,12414021
1826,22,22,12421053,12421403,366,12419388,12420183,864,12421047
1827,48,48,12427796,12428578,799,12426214,12426997,792,12427789
1828,42,42,12434688,12435371,700,12433024,12433811,872,12434683
1829,32,32,12441231,12441747,533,12439833,12440625,600,12441225
1830,40,40,12447957,12448607,666,12446642,12447439,512,12447951
1831,24,24,12454916,12455299,400,12453468,12454253,657,12454910
1832,36,36,12461926,12462508,599,12460277,12461067,852,12461919
1833,16,16,12468435,12468685,267,12467087,12467881,548,12468429
1834,46,46,12475544,12476293,766,12473913,12474695,843,12475538
1835,6,6,12482120,12482204,100,12480722,12481509,605,12482114
1836,2,2,12489246,12489263,33,12487531,12488323,917,12489240
1837,28,28,12495706,12496155,466,12494340,12495137,562,12495699
1838,22,22,12502765,12503114,366,12501166,12501951,807,12502758
1839,22,22,12509541,12509890,366,12507976,12508765,770,12509535
1840,6,6,12516350,12516433,100,12514785,12515579,765,12516344
1841,46,46,12523209,12523958,766,12521594,12522393,810,12523203
1842,2,2,12530202,12530218,33,12528420,12529207,988,12530195
1843,2,2,12536695,12536711,33,12535229,12536021,667,12536688
1844,30,30,12543454,12543937,499,12542039,12542835,613,12543448
1845,56,56,12550197,12551112,932,12548865,12549649,541,12550190
1846,6,6,12557156,12557239,100,12555674,12556463,686,12557149
1847,2,2,12563915,12563932,33,12562483,12563277,631,12563908
1848,22,22,12570924,12571274,366,12569293,12570091,827,12570918
1849,28,28,12577517,12577966,466,12576118,12576905,605,12577510
1850,50,50,12584543,12585358,832,12582928,12583719,818,12584537
1851,24,24,12591102,12591485,400,12589737,12590533,563,12591096
1852,60,60,12597895,12598877,999,12596563,12597347,541,12597888
1853,2,2,12604904,12604921,33,12603372,12604161,736,12604897
1854,40,40,12611763,12612412,666,12610182,12610975,782,12611757
1855,50,50,12618473,12619288,832,12616991,12617789,677,12618466
1856,50,50,12625415,12626231,832,12623817,12624603,806,12625409
1857,14,14,12631941,12632158,233,12630626,12631417,518,12631935
1858,20,20,12638867,12639183,333,12637435,12638231,629,12638860
1859,34,34,12645943,12646492,566,12644261,12645045,891,12645936
1860,52,52,12652785,12653634,866,12651071,12651859,921,12652780
1861,28,28,12659378,12659828,466,12657880,12658673,699,12659372
1862,2,2,12666470,12666487,34,12664689,12665487,977,12666464
1863,26,26,12673063,12673480,433,12671515,12672301,756,12673057
1864,56,56,12679706,12680622,932,12678324,12679115,584,12679699
1865,20,20,12686765,12687081,333,12685134,12685929,830,12686759
1866,38,38,12693375,12693991,632,12691960,12692743,626,12693369
1867,20,20,12700334,12700650,333,12698769,12699557,771,12700328
1868,20,20,12706893,12707210,333,12705578,12706371,516,12706887
1869,30,30,12714019,12714502,499,12712387,12713185,827,12714012
1870,30,30,12720512,12720995,499,12719213,12719999,506,12720505
1871,18,18,12727771,12728054,299,12726023,12726813,952,12727765
1872,10,10,12734430,12734580,167,12732832,12733627,797,12734424
1873,4,4,12741373,12741423,66,12739658,12740441,926,12741367
1874,36,36,12748149,12748731,599,12746467,12747255,887,12748142
1875,50,50,12754808,12755624,833,12753276,12754069,732,12754801
1876,4,4,12761468,12761517,66,12760086,12760883,578,12761461
1877,40,40,12768327,12768976,666,12766912,12767697,624,12768321
1878,38,38,12775486,12776102,632,12773721,12774511,969,12775480
1879,6,6,12782195,12782278,100,12780530,12781325,864,12782189
1880,36,36,12789121,12789704,599,12787356,12788139,976,12789115
1881,60,60,12795897,12796879,999,12794165,12794953,937,12795890
1882,36,36,12802473,12803056,599,12800975,12801767,700,12802467
1883,38,38,12809432,12810048,633,12807784,12808581,845,12809426
1884,20,20,12815942,12816258,333,12814610,12815395,540,12815935
1885,20,20,12823034,12823350,333,12821419,12822209,819,12823028
1886,16,16,12829927,12830176,266,12828228,12829023,897,12829920
1887,28,28,12836536,12836986,466,12835054,12835837,692,12836529
1888,10,10,12843495,12843645,167,12841864,12842651,838,12843489
1889,52,52,12850305,12851154,865,12848673,12849465,833,12850298
1890,40,40,12857180,12857830,666,12855482,12856279,895,12857174
1891,24,24,12864056,12864439,400,12862308,12863093,957,12864050
1892,20,20,12870483,12870799,333,12869117,12869907,569,12870476
1893,38,38,12876626,12877242,633,12875927,12875938,681,12876619
1894,60,60,12883752,12884734,999,12881954,12882752,994,12883746
1895,58,58,12890061,12891010,966,12888780,12889566,489,12890055
1896,46,46,12896954,12897703,766,12895589,12896380,568,12896948
1897,8,8,12903747,12903863,133,12902398,12903194,546,12903740
1898,28,28,12910689,12911139,466,12909224,12910008,675,12910683
1899,42,42,12917498,12918181,700,12916033,12916822,670,12917492
1900,54,54,12924408,12925290,899,12922843,12923636,766,12924402
1901,32,32,12930967,12931483,533,12929652,12930450,511,12930961
1902,54,54,12938009,12938892,900,12936478,12937264,739,12938003
1903,48,48,12944619,12945401,799,12943287,12944078,534,12944612
1904,54,54,12951795,12952677,899,12950096,12950892,896,12951788
1905,24,24,12958271,12958654,399,12956922,12957706,558,12958264
1906,30,30,12965080,12965563,500,12963732,12964520,554,12965074
1907,32,32,12972272,12972788,533,12970541,12971334,932,12972266
1908,10,10,12978749,12978898,166,12977350,12978148,594,12978742
1909,4,4,12985674,12985724,67,12984176,12984962,706,12985668
1910,48,48,12992567,12993349,799,12990985,12991776,784,12992560
1911,52,52,12999110,12999959,866,12997795,12998590,514,12999104
1912,56,56,13005953,13006868,932,13004621,13005404,542,13005946
1913,54,54,13012895,13013777,899,13011430,13012218,671,13012889
1914,22,22,13019904,13020254,366,13018239,13019032,866,13019898
1915,26,26,13026447,13026863,433,13025048,13025846,594,13026440
1916,6,6,13033506,13033589,100,13031874,13032660,839,13033499
1917,14,14,13040299,13040515,233,13038684,13039474,819,13040293
1918,42,42,13047075,13047757,699,13045493,13046288,780,13047068
1919,50,50,13053618,13054433,832,13052319,13053102,509,13053611
1920,20,20,13060460,13060776,333,13059128,13059916,537,13060453
1921,50,50,13067569,13068385,832,13065937,13066730,832,13067562
1922,32,32,13074512,13075028,532,13072747,13073544,962,13074506
1923,6,6,13080955,13081038,99,13079573,13080358,590,13080948
1924,42,42,13087847,13088530,699,13086382,13087172,669,13087841
1925,50,50,13094573,13095389,833,13093191,13093986,580,13094566
1926,36,36,13101799,13102381,599,13100017,13100800,992,13101792
1927,6,6,13108192,13108275,100,13106826,13107614,571,13108185
1928,50,50,13115184,13116000,833,13113636,13114428,750,13115178
1929,60,60,13121927,13122909,999,13120445,13121242,678,13121920
1930,26,26,13127987,13128403,433,13127271,13127273,707,13127980
1931,2,2,13134696,13134713,34,13133298,13134087,603,13134690
1932,16,16,13141589,13141839,266,13140107,13140901,681,13141582
1933,26,26,13148531,13148947,433,13146916,13147715,810,13148525
1934,42,42,13155291,13155973,699,13153742,13154529,755,13155284
1935,36,36,13162150,13162733,599,13160552,13161343,801,13162144
1936,2,2,13169042,13169059,34,13167361,13168157,879,13169036
1937,14,14,13175968,13176185,233,13174187,13174971,991,13175962
1938,4,4,13182761,13182811,66,13180996,13181785,970,13182755
1939,22,22,13189337,13189687,366,13187805,13188599,731,13189330
1940,38,38,13195963,13196579,633,13194615,13195413,544,13195957
1941,16,16,13203155,13203405,267,13201441,13202227,923,13203150
1942,28,28,13209865,13210314,466,13208250,13209041,818,13209859
1943,46,46,13216791,13217540,765,13215059,13215855,929,13216784
1944,24,24,13223500,13223883,400,13221885,13222669,825,13223494
1945,40,40,13230193,13230842,666,13228694,13229483,703,13230186
1946,44,44,13237035,13237751,733,13235504,13236297,732,13237029
1947,50,50,13243895,13244710,832,13242313,13243111,777,13243888
1948,56,56,13250487,13251403,933,13249139,13249925,556,13250481
1949,32,32,13257646,13258162,533,13255948,13256739,901,13257640
1950,24,24,13264089,13264472,400,13262757,13263553,529,13264082
1951,48,48,13271215,13271997,799,13269583,13270367,841,13271208
1952,30,30,13277741,13278224,500,13276393,13277181,554,13277735
1953,10,10,13284900,13285050,167,13283202,13283995,899,13284894
1954,6,6,13291643,13291726,100,13290011,13290809,827,13291636
1955,34,34,13298602,13299151,566,13296837,13297623,973,13298596
1956,42,42,13305378,13306061,699,13303646,13304437,934,13305371
1957,28,28,13312121,13312570,466,13310456,13311251,864,13312115
1958,58,58,13319030,13319979,965,13317282,13318065,959,13319024
1959,42,42,13325573,13326255,699,13324091,13324879,687,13325566
1960,16,16,13332265,13332515,267,13330900,13331693,566,13332259
1961,34,34,13339491,13340040,566,13337710,13338507,978,13339485
1962,46,46,13346034,13346783,766,13344535,13345321,706,13346027
1963,6,6,13352643,13352727,100,13351345,13352135,502,13352637
1964,42,42,13359836,13360518,699,13358154,13358949,880,13359829
1965,4,4,13366612,13366661,66,13364980,13365763,842,13366605
1966,8,8,13373338,13373454,133,13371789,13372577,754,13373331
1967,4,4,13380130,13380180,67,13378599,13379391,733,13380124
1968,10,10,13387056,13387206,167,13385408,13386205,845,13387050
1969,30,30,13393566,13394048,499,13392234,13393019,540,13393559
1970,20,20,13400791,13401107,333,13399043,13399833,952,13400785
1971,56,56,13407551,13408466,932,13405852,13406647,897,13407544
1972,34,34,13413977,13414526,566,13412678,13413461,509,13413970
1973,42,42,13420886,13421569,699,13419488,13420275,605,13420880
1974,44,44,13427845,13428561,733,13426297,13427089,750,13427839
1975,22,22,13434488,13434838,366,13433106,13433903,578,13434481
1976,16,16,13441580,13441830,267,13439932,13440717,857,13441574
1977,6,6,13448290,13448373,100,13446741,13447531,752,13448283
1978,34,34,13455066,13455615,566,13453551,13454345,715,13455060
1979,48,48,13461858,13462641,799,13460377,13461159,693,13461852
1980,20,20,13468518,13468834,333,13467186,13467973,538,13468511
1981,54,54,13475743,13476626,899,13473995,13474787,950,13475737
1982,52,52,13482486,13483335,866,13480804,13481601,878,13482479
1983,10,10,13489079,13489229,166,13487630,13488415,657,13489072
1984,60,60,13495039,13496021,999,13494440,13494446,586,13495032
1985,48,48,13501898,13502681,799,13500466,13501260,631,13501891
1986,38,38,13508641,13509257,633,13507276,13508074,561,13508635
1987,6,6,13515767,13515850,99,13514102,13514888,873,13515761
1988,44,44,13522359,13523075,733,13520911,13521702,651,13522353
1989,52,52,13529402,13530251,866,13527720,13528516,879,13529395
1990,42,42,13536161,13536844,699,13534546,13535330,825,13536155
1991,26,26,13542954,13543370,433,13541355,13542144,803,13542947
1992,58,58,13549896,13550845,966,13548165,13548958,932,13549890
1993,12,12,13556739,13556922,200,13554974,13555772,961,13556733
1994,30,30,13563182,13563665,499,13561800,13562586,589,13563175
1995,20,20,13570241,13570557,333,13568609,13569400,834,13570234
1996,22,22,13577033,13577383,367,13575419,13576214,814,13577028
1997,28,28,13583859,13584309,467,13582244,13583028,825,13583853
1998,40,40,13590502,13591151,666,13589054,13589842,654,13590496
1999,6,6,13597428,13597511,100,13595863,13596656,766,13597422
2000,8,8,13604321,13604437,133,13602672,13603470,844,13604314
2001,8,8,13611130,13611246,133,13609498,13610284,839,13611123
2002,58,58,13617889,13618838,966,13616308,13617098,785,13617883
2003,10,10,13624782,13624932,166,13623117,13623912,864,13624776
2004,38,38,13631441,13632057,633,13629943,13630726,709,13631435
2005,42,42,13638284,13638966,699,13636752,13637540,737,13638277
2006,26,26,13645126,13645543,433,13643561,13644354,766,13645120
2007,10,10,13651719,13651869,167,13650371,13651168,545,13651713
2008,48,48,13658945,13659727,799,13657197,13657982,957,13658939
2009,56,56,13665338,13666253,932,13664006,13664796,535,13665331
2010,18,18,13672247,13672530,300,13670815,13671610,630,13672240
2011,18,18,13678973,13679256,300,13677641,13678424,542,13678966
2012,24,24,13686049,13686432,399,13684450,13685238,804,13686042
2013,12,12,13692675,13692858,200,13691260,13692052,617,13692669
2014,38,38,13699617,13700233,633,13698069,13698866,745,13699611
2015,26,26,13706643,13707059,433,13704895,13705680,957,13706637
2016,36,36,13713003,13713585,599,13711704,13712494,502,13712996
2017,24,24,13719979,13720361,399,13718513,13719308,664,13719972
2018,18,18,13726821,13727104,300,13725339,13726122,692,13726814
2019,20,20,13733830,13734146,333,13732149,13732936,888,13733824
2020,24,24,13740306,13740689,400,13738958,13739750,550,13740300
2021,10,10,13747232,13747382,167,13745767,13746564,662,13747226
2022,56,56,13753892,13754807,932,13752593,13753378,507,13753885
2023,28,28,13760734,13761184,467,13759402,13760192,535,13760727
2024,10,10,13767860,13768010,166,13766212,13767006,848,13767854
2025,22,22,13774503,13774852,366,13773021,13773820,676,13774496
2026,38,38,13781595,13782211,633,13779847,13780634,955,13781589
2027,6,6,13788371,13788454,100,13786656,13787448,917,13788365
2028,10,10,13795064,13795214,166,13793466,13794262,796,13795058
2029,42,42,13801590,13802273,699,13800291,13801076,507,13801583
2030,4,4,13808582,13808632,67,13807101,13807890,686,13808576
2031,14,14,13815558,13815775,233,13813910,13814704,848,13815552
2032,36,36,13822035,13822617,599,13820719,13821518,510,13822028
2033,10,10,13829027,13829177,166,13827545,13828332,688,13829020
2034,2,2,13835770,13835786,33,13834355,13835146,618,13835764
2035,4,4,13842812,13842862,67,13841164,13841960,846,13842806
2036,24,24,13849621,13850004,400,13847990,13848774,841,13849615
2037,36,36,13856514,13857097,599,13854799,13855588,920,13856508
2038,4,4,13863373,13863423,67,13861608,13862402,965,13863367
2039,44,44,13869749,13870465,733,13868418,13869216,527,13869743
2040,50,50,13876908,13877724,833,13875244,13876030,873,13876903
2041,14,14,13883751,13883967,233,13882053,13882844,901,13883745
2042,4,4,13890244,13890294,67,13888862,13889658,579,13890237
2043,34,34,13897286,13897836,566,13895688,13896472,808,13897280
2044,26,26,13903779,13904195,433,13902497,13903286,486,13903772
2045,24,24,13910922,13911304,399,13909307,13910100,816,13910916
2046,38,38,13917514,13918130,633,13916116,13916914,594,13917508
2047,14,14,13924440,13924657,233,13922942,13923728,706,13924434
2048,56,56,13931100,13932015,932,13929751,13930542,551,13931093
2049,24,24,13937959,13938342,399,13936560,13937356,596,13937952
2050,36,36,13944702,13945284,599,13943386,13944170,525,13944695
2051,12,12,13951927,13952110,200,13950196,13950984,937,13951921
2052,8,8,13958553,13958670,133,13957005,13957798,749,13958547
2053,32,32,13965429,13965945,533,13963814,13964612,811,13965423
2054,14,14,13972422,13972638,233,13970640,13971426,989,13972415
2055,26,26,13979198,13979614,432,13977449,13978240,951,13979191
2056,6,6,13985641,13985724,99,13984259,13985054,580,13985634
2057,54,54,13992650,13993532,899,13991085,13991868,776,13992644
2058,38,38,13999193,13999809,632,13997894,13998682,504,13999186
2059,54,54,14006202,14007084,899,14004703,14005496,699,14006195
2060,34,34,14013177,14013727,566,14011512,14012310,861,14013171
2061,54,54,14019637,14020519,899,14018338,14019124,506,14019630
2062,40,40,14026746,14027395,666,14025148,14025938,802,14026740
2063,10,10,14033705,14033855,167,14031957,14032752,947,14033699
2064,2,2,14040431,14040448,33,14038783,14039566,859,14040425
2065,38,38,14047207,14047823,633,14045592,14046380,821,14047201
2066,52,52,14053767,14054616,865,14052402,14053194,567,14053761
2067,54,54,14060809,14061691,899,14059211,14060008,795,14060803
2068,40,40,14067452,14068101,666,14066037,14066822,624,14067446
2069,34,34,14074294,14074844,567,14072846,14073636,652,14074288
2070,22,22,14081220,14081570,367,14079655,14080450,764,14081214
2071,58,58,14087880,14088829,965,14086481,14087264,609,14087873
2072,60,60,14094589,14095571,999,14093291,14094078,505,14094583
2073,52,52,14101865,14102714,865,14100100,14100892,967,14101859
2074,24,24,14108291,14108674,400,14106909,14107706,578,14108284
2075,48,48,14115350,14116132,799,14113735,14114520,824,14115344
2076,38,38,14121993,14122609,632,14120544,14121334,652,14121986
2077,8,8,14129135,14129252,133,14127354,14128148,981,14129129
2078,8,8,14135511,14135628,134,14134180,14134962,543,14135505
2079,26,26,14142620,14143037,433,14140989,14141776,838,14142614
2080,48,48,14149563,14150345,799,14147798,14148590,967,14149557
2081,2,2,14156039,14156056,33,14154607,14155404,628,14156032
2082,8,8,14163098,14163215,133,14161433,14162218,874,14163092
2083,10,10,14169558,14169708,166,14168243,14169032,520,14169552
2084,22,22,14176534,14176883,366,14175052,14175846,681,14176527
2085,56,56,14183559,14184475,933,14181861,14182660,893,14183553
2086,50,50,14190036,14190851,832,14188687,14189474,555,14190029
2087,42,42,14196945,14197627,699,14195496,14196288,650,14196938
2088,58,58,14203904,14204853,966,14202306,14203102,796,14203898
2089,48,48,14210480,14211263,799,14209132,14209916,558,14210474
2090,54,54,14217389,14218272,899,14215941,14216730,653,14217383
2091,48,48,14224382,14225164,799,14222750,14223544,831,14224375
2092,60,60,14230941,14231924,999,14229559,14230358,576,14230934
2093,28,28,14237767,14238217,466,14236385,14237172,588,14237760
2094,26,26,14244577,14244993,432,14243195,14243986,584,14244570
2095,12,12,14251652,14251835,200,14250004,14250800,846,14251646
2096,14,14,14258511,14258728,234,14256830,14257614,891,14258505
2097,2,2,14264971,14264988,33,14263639,14264428,536,14264964
2098,50,50,14272213,14273029,833,14270448,14271242,965,14272207
2099,16,16,14278706,14278956,267,14277258,14278056,644,14278700
2100,54,54,14285582,14286464,899,14284084,14284870,706,14285576
2101,40,40,14292441,14293091,666,14290893,14291684,751,14292435
2102,24,24,14299284,14299667,399,14297702,14298498,779,14299277
2103,40,40,14305943,14306593,666,14304528,14305312,625,14305937
2104,58,58,14312886,14313835,965,14311337,14312126,753,14312879
2105,54,54,14319845,14320727,899,14318147,14318940,899,14319839
2106,54,54,14326571,14327453,899,14324956,14325754,811,14326565
2107,46,46,14333297,14334046,766,14331782,14332568,723,14333291
2108,8,8,14340173,14340289,133,14338591,14339382,784,14340166
2109,16,16,14346882,14347132,267,14345401,14346196,680,14346876
2110,26,26,14353791,14354208,433,14352227,14353010,776,14353786
2111,40,40,14360634,14361283,666,14359036,14359824,804,14360628
2112,60,60,14367343,14368326,999,14365845,14366638,699,14367337
2113,46,46,14374186,14374935,766,14372654,14373452,727,14374179
2114,60,60,14381062,14382044,999,14379480,14380266,789,14381055
2115,44,44,14386972,14387688,733,14386290,14386297,668,14386965
2116,46,46,14393765,14394514,766,14392316,14393111,647,14393758
2117,14,14,14400840,14401057,234,14399142,14399925,909,14400834
2118,56,56,14407483,14408399,933,14405952,14406739,738,14407477
2119,24,24,14414526,14414909,399,14412761,14413553,967,14414520
2120,40,40,14420935,14421585,666,14419570,14420367,562,14420929
2121,20,20,14428161,14428477,333,14426396,14427181,974,14428155
2122,12,12,14434804,14434987,199,14433205,14433995,802,14434797
2123,20,20,14441813,14442129,333,14440015,14440809,998,14441807
2124,16,16,14448206,14448456,266,14446841,14447623,577,14448200
2125,16,16,14455398,14455648,266,14453650,14454437,955,14455392
2126,8,8,14462207,14462324,133,14460459,14461251,950,14462201
2127,50,50,14468584,14469399,832,14467268,14468065,512,14468577
2128,6,6,14475376,14475460,100,14474094,14474879,490,14475369
2129,10,10,14482602,14482752,166,14480904,14481693,903,14482596
2130,10,10,14489211,14489361,167,14487713,14488507,698,14489205
2131,60,60,14496320,14497303,999,14494522,14495321,993,14496314
2132,8,8,14503013,14503130,133,14501348,14502135,872,14503007
2133,4,4,14509806,14509856,66,14508157,14508949,850,14509799
2134,8,8,14516648,14516765,133,14514967,14515763,879,14516642
2135,50,50,14523358,14524173,832,14521793,14522577,775,14523352
2136,14,14,14530100,14530317,233,14528602,14529391,703,14530094
2137,40,40,14536727,14537376,665,14535411,14536205,515,14536720
2138,48,48,14543536,14544318,799,14542221,14543019,511,14543530
2139,32,32,14550495,14551011,533,14549046,14549833,655,14550488
2140,46,46,14557154,14557904,766,14555856,14556647,501,14557148
2141,28,28,14564446,14564896,467,14562665,14563461,979,14564440
2142,30,30,14570790,14571272,499,14569491,14570275,508,14570783
2143,48,48,14578082,14578864,799,14576300,14577089,986,14578075
2144,30,30,14584858,14585340,499,14583110,14583903,949,14584852
2145,32,32,14591700,14592216,533,14589919,14590717,977,14591694
2146,44,44,14598060,14598776,733,14596745,14597531,523,14598054
2147,14,14,14605169,14605385,233,14603554,14604345,818,14605163
2148,16,16,14611912,14612161,266,14610363,14611159,746,14611905
2149,36,36,14618638,14619220,599,14617189,14617973,658,14618631
2150,2,2,14625763,14625780,34,14623999,14624787,971,14625758
2151,60,60,14632473,14633455,999,14630808,14631601,866,14632467
2152,14,14,14639066,14639282,233,14637617,14638415,644,14639059
2153,52,52,14645775,14646624,866,14644443,14645229,539,14645768
2154,60,60,14652534,14653517,999,14651252,14652043,484,14652527
2155,50,50,14659710,14660526,832,14658062,14658857,847,14659704
2156,10,10,14666236,14666386,167,14664888,14665671,559,14666230
2157,26,26,14672995,14673412,433,14671697,14672485,504,14672989
2158,14,14,14680021,14680238,233,14678506,14679299,716,14680015
2159,18,18,14686647,14686930,300,14685315,14686113,527,14686640
2160,38,38,14693656,14694272,633,14692141,14692927,723,14693650
2161,34,34,14700699,14701248,566,14698951,14699741,952,14700693
2162,14,14,14707525,14707741,233,14705760,14706555,964,14707519
2163,34,34,14714367,14714917,566,14712586,14713369,992,14714361
2164,26,26,14720993,14721410,433,14719395,14720183,804,14720987
2165,12,12,14727953,14728136,199,14726204,14726997,949,14727946
2166,60,60,14734462,14735444,999,14733014,14733811,645,14734456
2167,38,38,14741604,14742220,633,14739840,14740625,974,14741599
2168,10,10,14747981,14748131,166,14746649,14747439,535,14747974
2169,12,12,14754957,14755140,199,14753458,14754253,697,14754950
2170,2,2,14761666,14761683,33,14760284,14761067,592,14761659
2171,30,30,14768625,14769108,500,14767093,14767881,737,14768618
2172,44,44,14775351,14776067,733,14773903,14774695,650,14775345
2173,38,38,14782443,14783059,633,14780712,14781509,928,14782437
2174,58,58,14789053,14790002,966,14787538,14788323,724,14789047
2175,50,50,14796029,14796845,832,14794347,14795137,885,14796022
2176,10,10,14802605,14802755,166,14801157,14801951,648,14802599
2177,26,26,14809481,14809897,433,14807982,14808765,709,14809474
2178,32,32,14816257,14816773,533,14814792,14815579,672,14816251
2179,26,26,14823299,14823715,433,14821601,14822393,900,14823293
2180,52,52,14829959,14830808,865,14828410,14829207,745,14829952
2181,28,28,14836934,14837384,467,14835236,14836021,907,14836928
2182,26,26,14843544,14843960,433,14842046,14842835,703,14843538
2183,44,44,14850303,14851019,733,14848855,14849649,648,14850297
2184,44,44,14856979,14857695,733,14855664,14856463,510,14856973
2185,42,42,14863772,14864455,699,14862490,14863277,488,14863765
2186,24,24,14871064,14871447,400,14869299,14870091,967,14871058
2187,14,14,14877823,14878040,234,14876109,14876905,913,14877818
2188,20,20,14884466,14884783,333,14882935,14883719,741,14884460
2189,18,18,14891525,14891808,300,14889744,14890533,986,14891519
2190,42,42,14897885,14898568,699,14896553,14897347,531,14897878
2191,52,52,14904827,14905677,866,14903362,14904161,660,14904821
2192,48,48,14911637,14912419,799,14910188,14910975,655,14911630
2193,6,6,14918579,14918662,100,14916998,14917789,784,14918573
2194,38,38,14925488,14926104,633,14923807,14924603,879,14925482
2195,58,58,14932298,14933247,965,14930633,14931417,875,14932292
2196,18,18,14939090,14939373,300,14937442,14938231,853,14939084
2197,46,46,14945850,14946599,766,14944251,14945045,798,14945843
2198,52,52,14952842,14953691,866,14951061,14951859,977,14952836
2199,32,32,14959252,14959768,533,14957887,14958673,573,14959246
2200,48,48,14965995,14966777,799,14964696,14965487,501,14965988
2201,52,52,14973237,14974086,865,14971505,14972301,929,14973230
2202,42,42,14979646,14980329,700,14978331,14979115,525,14979640
2203,12,12,14986872,14987055,200,14985140,14985929,936,14986865
2204,28,28,14993731,14994181,466,14991950,14992743,982,14993725
2205,18,18,15000557,15000840,300,14998759,14999557,994,15000551
2206,46,46,15007266,15008016,766,15005585,15006371,889,15007260
2207,28,28,15013693,15014142,466,15012394,15013185,501,15013686
2208,56,56,15020702,15021618,932,15019204,15019999,697,15020696
2209,36,36,15027578,15028160,599,15026029,15026813,758,15027571
2210,12,12,15034603,15034787,200,15032839,15033627,971,15034598
2211,8,8,15041330,15041446,133,15039648,15040441,882,15041323
2212,54,54,15048072,15048955,899,15046457,15047255,811,15048066
2213,6,6,15055015,15055098,100,15053283,15054069,939,15055008
2214,8,8,15061491,15061608,133,15060093,15060883,602,15061485
2215,18,18,15068517,15068800,299,15066902,15067697,814,15068511
2216,22,22,15075459,15075809,366,15073728,15074511,942,15075453
2217,54,54,15082252,15083134,899,15080537,15081325,921,15082246
2218,10,10,15088928,15089078,166,15087346,15088139,782,15088921
2219,44,44,15095771,15096486,732,15094156,15094953,812,15095765
2220,42,42,15102763,15103446,699,15100982,15101767,990,15102757
2221,36,36,15109556,15110138,599,15107791,15108581,969,15109550
2222,38,38,15116165,15116781,633,15114600,15115395,764,15116159
2223,52,52,15122791,15123640,866,15121426,15122209,576,15122785
2224,38,38,15129983,15130599,633,15128235,15129023,954,15129977
2225,20,20,15136726,15137042,333,15135045,15135837,883,15136720
2226,30,30,15143269,15143752,500,15141854,15142651,612,15143263
2227,22,22,15150095,15150445,366,15148680,15149465,624,15150089
2228,48,48,15156821,15157603,799,15155489,15156279,535,15156814
2229,36,36,15163747,15164330,599,15162298,15163093,647,15163740
2230,12,12,15170456,15170639,200,15169124,15169907,542,15170449
2231,18,18,15177482,15177765,300,15175934,15176721,755,15177476
2232,20,20,15184408,15184724,333,15182743,15183535,867,15184402
2233,48,48,15191051,15191833,799,15189552,15190349,695,15191044
2234,36,36,15197910,15198492,599,15196378,15197163,740,15197903
2235,20,20,15204869,15205185,333,15203187,15203977,885,15204862
2236,42,42,15211728,15212411,699,15209997,15210791,931,15211722
2237,42,42,15218338,15219020,699,15216806,15217605,726,15218331
2238,40,40,15225247,15225896,666,15223632,15224419,822,15225241
2239,36,36,15231940,15232522,599,15230441,15231233,700,15231933
2240,12,12,15238699,15238882,200,15237250,15238047,645,15238692
2241,30,30,15245825,15246307,499,15244076,15244861,957,15245818
2242,28,28,15252417,15252867,467,15250886,15251675,736,15252411
2243,54,54,15259377,15260259,899,15257695,15258489,881,15259370
2244,48,48,15266136,15266918,799,15264504,15265303,826,15266129
2245,16,16,15272679,15272928,266,15271330,15272117,555,15272672
2246,26,26,15279521,15279938,433,15278139,15278931,583,15279514
2247,8,8,15286697,15286813,133,15284949,15285745,946,15286691
2248,48,48,15293506,15294289,799,15291775,15292559,941,15293500
2249,24,24,15299982,15300365,400,15298584,15299373,603,15299976
2250,40,40,15306692,15307341,666,15305393,15306187,498,15306685
2251,48,48,15313951,15314733,799,15312203,15313001,944,15313945
2252,6,6,15320510,15320593,100,15319029,15319815,689,15320504
2253,26,26,15327203,15327619,433,15325838,15326629,568,15327197
2254,32,32,15333996,15334512,532,15332647,15333443,546,15333989
2255,28,28,15341071,15341521,466,15339473,15340257,808,15341065
2256,2,2,15347631,15347647,33,15346282,15347071,553,15347624
2257,40,40,15354873,15355522,666,15353092,15353885,982,15354867
2258,36,36,15361616,15362198,599,15359901,15360699,911,15361610
2259,12,12,15368242,15368425,200,15366727,15367513,723,15368236
2260,54,54,15374868,15375750,899,15373536,15374327,534,15374861
2261,32,32,15382010,15382526,533,15380345,15381141,863,15382004
2262,16,16,15388620,15388869,266,15387171,15387955,658,15388613
2263,54,54,15395546,15396428,899,15393981,15394769,771,15395540
2264,50,50,15402088,15402904,833,15400790,15401583,499,15402082
2265,24,24,15409297,15409680,400,15407599,15408397,894,15409291
2266,24,24,15416123,15416506,400,15414425,15415211,906,15416117
2267,30,30,15422883,15423365,499,15421234,15422025,851,15422876
2268,42,42,15429609,15430291,699,15428044,15428839,764,15429603
2269,40,40,15436318,15436967,666,15434870,15435653,659,15436312
2270,6,6,15443127,15443211,100,15441679,15442467,654,15443121
2271,14,14,15449454,15449670,233,15448488,15448498,949,15449447
2272,56,56,15456063,15456979,933,15454515,15455312,745,15456057
2273,22,22,15462939,15463289,366,15461341,15462126,807,15462933
2274,54,54,15469582,15470464,899,15468150,15468940,635,15469575
2275,2,2,15476624,15476641,34,15474959,15475754,864,15476618
2276,6,6,15483550,15483633,100,15481785,15482568,976,15483544
2277,4,4,15490310,15490359,66,15488595,15489382,922,15490304
2278,26,26,15497102,15497518,433,15495404,15496196,900,15497096
2279,22,22,15503712,15504061,366,15502213,15503010,695,15503705
2280,10,10,15510521,15510671,166,15509039,15509824,690,15510514
2281,40,40,15517513,15518163,666,15515848,15516638,869,15517507
2282,40,40,15524123,15524772,666,15522658,15523452,665,15524117
2283,58,58,15531032,15531981,966,15529467,15530266,760,15531026
2284,10,10,15537592,15537741,166,15536293,15537080,505,15537585
2285,32,32,15544701,15545217,532,15543102,15543894,800,15544694
2286,28,28,15551626,15552076,467,15549912,15550708,913,15551621
2287,20,20,15558436,15558752,333,15556738,15557522,908,15558430
2288,12,12,15565062,15565245,200,15563547,15564336,720,15565056
2289,6,6,15571721,15571805,100,15570356,15571150,565,15571715
2290,36,36,15578780,15579363,600,15577165,15577964,810,15578774
2291,38,38,15585523,15586139,633,15583991,15584778,738,15585516
2292,30,30,15592432,15592915,500,15590801,15591592,834,15592426
2293,60,60,15598925,15599907,999,15597610,15598406,513,15598919
2294,16,16,15606134,15606384,266,15604436,15605220,908,15606128
2295,2,2,15611761,15611778,34,15611245,15611251,503,15611754
2296,28,28,15618903,15619353,467,15617272,15618065,832,15618897
2297,30,30,15625863,15626345,499,15624081,15624879,977,15625856
2298,22,22,15632455,15632805,367,15630907,15631693,756,15632449
2299,48,48,15639431,15640214,799,15637716,15638507,918,15639425
2300,46,46,15646174,15646923,766,15644526,15645321,847,15646168
2301,6,6,15653050,15653133,100,15651352,15652135,909,15653044
2302,54,54,15659842,15660725,899,15658161,15658949,887,15659836
2303,52,52,15666519,15667368,865,15664970,15665763,749,15666512
2304,20,20,15673528,15673844,333,15671779,15672577,944,15673521
2305,46,46,15680320,15681069,766,15678605,15679391,923,15680314
2306,12,12,15686946,15687129,200,15685415,15686205,735,15686940
2307,24,24,15693739,15694122,400,15692224,15693019,714,15693733
2308,54,54,15700332,15701214,899,15699050,15699833,492,15700325
2309,46,46,15707341,15708090,766,15705859,15706647,687,15707334
2310,48,48,15714134,15714916,799,15712668,15713461,666,15714127
2311,10,10,15720860,15721009,166,15719478,15720275,578,15720853
2312,26,26,15727802,15728218,433,15726304,15727089,707,15727796
2313,58,58,15734412,15735361,965,15733113,15733903,502,15734405
2314,16,16,15741587,15741837,267,15739922,15740717,864,15741581
2315,28,28,15748297,15748746,466,15746748,15747531,759,15748290
2316,16,16,15755156,15755405,266,15753557,15754345,804,15755149
2317,44,44,15761732,15762448,733,15760367,15761159,567,15761726
2318,38,38,15768957,15769573,633,15767176,15767973,978,15768951
2319,42,42,15775367,15776050,699,15774002,15774787,574,15775361
2320,56,56,15782543,15783458,932,15780811,15781601,935,15782536
2321,60,60,15789186,15790168,998,15787621,15788415,765,15789180
2322,56,56,15796228,15797144,932,15794446,15795229,992,15796221
2323,10,10,15802721,15802871,166,15801256,15802043,672,15802715
2324,32,32,15809430,15809946,533,15808065,15808857,567,15809424
2325,38,38,15816356,15816972,633,15814874,15815671,678,15816349
2326,38,38,15823482,15824098,632,15821700,15822485,990,15823475
2327,48,48,15829975,15830757,799,15828510,15829299,670,15829969
2328,56,56,15836684,15837600,932,15835319,15836113,565,15836678
2329,50,50,15843560,15844376,832,15842128,15842927,626,15843553
2330,42,42,15850303,15850985,699,15848954,15849741,555,15850296
2331,28,28,15857212,15857661,466,15855763,15856555,650,15857205
2332,40,40,15864221,15864870,666,15862573,15863369,846,15864215
2333,38,38,15871063,15871679,633,15869399,15870183,875,15871058
2334,32,32,15877906,15878422,533,15876208,15876997,903,15877900
2335,60,60,15884699,15885681,999,15883017,15883811,881,15884692
2336,50,50,15891192,15892007,832,15889826,15890625,560,15891185
2337,22,22,15898367,15898717,366,15896652,15897439,922,15898361
2338,10,10,15905176,15905326,167,15903462,15904253,918,15905171
2339,60,60,15911753,15912735,999,15910271,15911067,679,15911746
2340,16,16,15918462,15918712,266,15917097,15917881,575,15918456
2341,20,20,15925438,15925754,333,15923906,15924695,736,15925431
2342,12,12,15932230,15932414,200,15930715,15931509,715,15932224
2343,48,48,15938940,15939722,799,15937525,15938323,611,15938934
2344,52,52,15945882,15946731,866,15944351,15945137,739,15945876
2345,22,22,15952542,15952891,366,15951160,15951951,584,15952535
2346,8,8,15959734,15959851,133,15957969,15958765,963,15959728
2347,38,38,15966110,15966726,633,15964795,15965579,525,15966104
2348,54,54,15973336,15974218,899,15971604,15972393,936,15973329
2349,42,42,15979962,15980645,699,15978414,15979207,749,15979956
2350,16,16,15986705,15986954,266,15985223,15986021,677,15986698
2351,40,40,15993564,15994213,666,15992049,15992835,723,15993558
2352,16,16,16000340,16000590,266,15998858,15999649,684,16000333
2353,48,48,16007066,16007849,799,16005668,16006463,597,16007060
2354,22,22,16013975,16014325,366,16012493,16013277,691,16013968
2355,20,20,16020984,16021301,333,16019303,16020091,887,16020978
2356,42,42,16027444,16028127,699,16026112,16026905,532,16027437
2357,14,14,16034669,16034886,234,16032921,16033719,944,16034663
2358,32,32,16041329,16041845,533,16039747,16040533,789,16041322
2359,6,6,16048122,16048205,99,16046557,16047347,769,16048116
2360,18,18,16055031,16055314,299,16053366,16054161,864,16055025
2361,20,20,16061907,16062223,333,16060192,16060975,926,16061901
2362,38,38,16068416,16069032,633,16067001,16067789,621,16068410
2363,14,14,16075542,16075758,233,16073810,16074603,932,16075535
2364,12,12,16082018,16082201,200,16080620,16081417,595,16082012
2365,60,60,16088894,16089876,999,16087446,16088231,657,16088888
2366,8,8,16095886,16096003,134,16094255,16095045,835,16095880
2367,38,38,16102413,16103029,632,16101064,16101859,547,16102406
2368,4,4,16109472,16109522,66,16107890,16108673,792,16109465
2369,10,10,16116048,16116198,166,16114699,16115487,554,16116041
2370,14,14,16123173,16123390,234,16121509,16122301,867,16123168
2371,44,44,16129683,16130399,733,16128318,16129115,562,16129677
2372,10,10,16136676,16136825,166,16135144,16135929,740,16136669
2373,50,50,16143735,16144550,832,16141953,16142743,985,16143728
2374,54,54,16150294,16151176,899,16148762,16149557,730,16150287
2375,54,54,16156954,16157836,899,16155588,16156371,576,16156947
2376,50,50,16164112,16164928,833,16162398,16163185,922,16164107
2377,32,32,16170622,16171138,533,16169207,16169999,617,16170616
2378,14,14,16177348,16177565,233,16176016,16176813,528,16177341
2379,42,42,16184257,16184940,700,16182842,16183627,624,16184251
2380,22,22,16191200,16191549,366,16189651,16190441,752,16191193
2381,52,52,16198009,16198858,866,16196461,16197255,748,16198003
2382,20,20,16204585,16204902,333,16203270,16204069,510,16204579
2383,10,10,16211444,16211594,167,16210096,16210883,555,16211438
2384,38,38,16218270,16218886,633,16216905,16217697,567,16218264
2385,40,40,16225496,16226145,666,16223715,16224511,979,16225490
2386,36,36,16231822,16232405,600,16230540,16231325,490,16231815
2387,32,32,16239015,16239531,532,16237350,16238139,870,16239009
2388,2,2,16245607,16245624,34,16244159,16244953,648,16245601
2389,32,32,16252583,16253099,533,16250968,16251767,810,16252577
2390,14,14,16259243,16259459,233,16257794,16258581,655,16259236
2391,14,14,16266352,16266568,233,16264604,16265395,951,16266346
2392,14,14,16272828,16273044,233,16271413,16272209,613,16272822
2393,4,4,16279937,16279987,67,16278239,16279023,908,16279931
2394,40,40,16286546,16287196,666,16285048,16285837,703,16286540
2395,60,60,16293206,16294188,999,16291857,16292651,548,16293199
2396,42,42,16299998,16300681,700,16298667,16299465,527,16299992
2397,30,30,16306874,16307357,500,16305493,16306279,589,16306868
2398,58,58,16313850,16314799,966,16312302,16313093,751,16313844
2399,52,52,16320560,16321409,865,16319111,16319907,646,16320553
2400,28,28,16327369,16327818,466,16325937,16326721,641,16327362
2401,58,58,16334328,16335277,966,16332746,16333535,786,16334321
2402,6,6,16341154,16341237,100,16339556,16340349,799,16341148
2403,58,58,16348096,16349045,966,16346365,16347163,927,16348090
2404,36,36,16354839,16355422,599,16353191,16353977,856,16354833
2405,30,30,16361349,16361831,499,16360000,16360791,551,16361342
2406,28,28,16368408,16368857,466,16366809,16367605,796,16368401
2407,28,28,16375333,16375783,467,16373635,16374419,908,16375327
2408,44,44,16381893,16382609,733,16380445,16381233,654,16381887
2409,48,48,16389035,16389818,799,16387254,16388047,982,16389029
2410,14,14,16395678,16395895,233,16394063,16394861,811,16395672
2411,8,8,16402637,16402754,133,16400889,16401675,956,16402631
2412,26,26,16409247,16409663,433,16407698,16408489,751,16409240
2413,12,12,16416156,16416339,200,16414508,16415303,847,16416150
2414,46,46,16422782,16423531,766,16421334,16422117,659,16422776
2415,48,48,16429658,16430440,799,16428143,16428931,721,16429652
2416,4,4,16436517,16436567,67,16434952,16435745,766,16436511
2417,40,40,16443543,16444192,666,16441761,16442559,977,16443536
2418,28,28,16450119,16450569,466,16448587,16449373,739,16450112
2419,44,44,16456745,16457461,733,16455397,16456187,552,16456739
2420,34,34,16463987,16464537,566,16462206,16463001,980,16463981
2421,26,26,16470447,16470863,433,16469032,16469815,626,16470441
2422,42,42,16477156,16477839,700,16475841,16476629,521,16477150
2423,26,26,16484215,16484632,433,16482650,16483443,766,16484209
2424,56,56,16490958,16491874,932,16489460,16490257,695,16490952
2425,52,52,16497618,16498467,865,16496286,16497071,540,16497611
2426,60,60,16504843,16505825,999,16503095,16503885,952,16504837
2427,32,32,16511586,16512102,533,16509904,16510699,880,16511579
2428,30,30,16518062,16518545,500,16516730,16517513,542,16518055
2429,8,8,16524838,16524955,133,16523540,16524327,505,16524832
2430,56,56,16532080,16532996,933,16530349,16531141,933,16532074
2431,24,24,16538923,16539306,399,16537158,16537955,962,16538917
2432,6,6,16545549,16545632,100,16543984,16544769,774,16545543
2433,40,40,16552491,16553141,666,16550793,16551583,902,16552485
2434,6,6,16559018,16559101,100,16557603,16558397,615,16559012
2435,40,40,16566027,16566676,666,16564429,16565211,810,16566021
2436,60,60,16572586,16573569,999,16571238,16572025,555,16572580
2437,10,10,16579795,16579945,167,16578047,16578839,950,16579789
2438,56,56,16586405,16587320,932,16584856,16585653,745,16586398
2439,4,4,16593331,16593380,66,16591682,16592467,857,16593324
2440,36,36,16599940,16600523,599,16598492,16599281,653,16599934
2441,30,30,16606899,16607382,500,16605301,16606095,798,16606893
2442,42,42,16613825,16614508,699,16612110,16612909,910,16613819
2443,34,34,16620551,16621100,566,16618936,16619723,822,16620545
2444,36,36,16627094,16627677,599,16625745,16626537,550,16627087
2445,2,2,16634103,16634120,33,16632555,16633351,746,16634097
2446,40,40,16640929,16641578,666,16639381,16640165,758,16640923
2447,22,22,16647855,16648204,366,16646190,16646979,870,16647849
2448,40,40,16654314,16654964,666,16652999,16653793,515,16654308
2449,22,22,16661407,16661756,366,16659808,16660607,793,16661400
2450,22,22,16667966,16668316,367,16666634,16667421,538,16667959
2451,12,12,16674859,16675042,200,16673444,16674235,618,16674853
2452,56,56,16681635,16682550,932,16680253,16681049,579,16681628
2453,18,18,16688860,16689143,300,16687079,16687863,991,16688854
2454,24,24,16695653,16696036,400,16693888,16694677,970,16695647
2455,56,56,16702113,16703028,932,16700697,16701491,615,16702106
2456,22,22,16709272,16709621,366,16707507,16708305,961,16709266
2457,30,30,16715781,16716264,500,16714333,16715119,656,16715775
2458,6,6,16722890,16722973,100,16721142,16721933,951,16722884
2459,18,18,16729566,16729849,300,16727951,16728747,813,16729560
2460,8,8,16736559,16736675,133,16734777,16735561,991,16736552
2461,20,20,16742934,16743250,333,16741585,16742375,552,16742927
2462,26,26,16749827,16750243,432,16748395,16749189,631,16749820
2463,42,42,16756736,16757418,699,16755204,16756003,726,16756729
2464,6,6,16763711,16763795,100,16762030,16762817,888,16763705
2465,10,10,16770521,16770671,166,16768839,16769631,883,16770514
2466,12,12,16777313,16777497,200,16775649,16776445,863,16777308
2467,26,26,16784039,16784456,433,16782474,16783259,773,16784032
2468,40,40,16790716,16791365,666,16789284,16790073,635,16790708
2469,36,36,16797558,16798141,600,16796093,16796887,665,16797552
2470,14,14,16804434,16804650,233,16802902,16803701,727,16804428
2471,10,10,16811360,16811510,166,16809728,16810515,837,16811352
2472,24,24,16817986,16818369,400,16816538,16817329,651,16817980
2473,6,6,16825095,16825178,100,16823347,16824143,945,16825088
2474,22,22,16831921,16832271,366,16830173,16830957,959,16831916
2475,16,16,16838664,16838913,266,16836982,16837771,885,16838656
2476,8,8,16845290,16845406,133,16843791,16844585,699,16845284
2477,26,26,16852216,16852632,432,16850601,16851399,811,16852210
2478,10,10,16858742,16858892,166,16857427,16858213,523,16858736
2479,14,14,16865584,16865801,233,16864236,16865027,551,16865578
2480,42,42,16872577,16873259,699,16871045,16871841,729,16872570
2481,30,30,16879652,16880135,500,16877871,16878655,991,16879646
2482,32,32,16886162,16886678,533,16884680,16885469,687,16886156
2483,24,24,16892905,16893288,399,16891490,16892283,617,16892900
2484,12,12,16899764,16899947,200,16898299,16899097,661,16899758
2485,10,10,16906623,16906773,167,16905125,16905911,705,16906616
2486,54,54,16913582,16914465,899,16911934,16912725,851,16913576
2487,30,30,16920275,16920758,500,16918743,16919539,729,16920268
2488,54,54,16927168,16928050,899,16925569,16926353,807,16927160
2489,56,56,16933977,16934893,932,16932379,16933167,805,16933972
2490,30,30,16940936,16941419,500,16939188,16939981,949,16940930
2491,14,14,16947346,16947562,233,16945997,16946795,545,16947340
2492,6,6,16954205,16954288,100,16952823,16953609,589,16954198
2493,18,18,16960998,16961281,299,16959632,16960423,569,16960992
2494,36,36,16968140,16968723,599,16966442,16967237,897,16968134
2495,32,32,16974966,16975482,533,16973268,16974051,909,16974960
2496,20,20,16981825,16982141,333,16980077,16980865,955,16981820
2497,30,30,16988468,16988951,499,16986886,16987679,781,16988460
2498,10,10,16995111,16995260,166,16993696,16994493,611,16995104
2499,14,14,17001837,17002053,233,17000521,17001307,523,17001830
2500,20,20,17009012,17009329,333,17007331,17008121,885,17009006
2501,54,54,17015572,17016454,899,17014140,17014935,629,17015564
2502,10,10,17022481,17022631,166,17020966,17021749,727,17022476
2503,54,54,17029340,17030223,899,17027775,17028563,771,17029334
2504,54,54,17036316,17037198,899,17034585,17035377,933,17036310
2505,54,54,17043042,17043924,899,17041394,17042191,845,17043036
2506,4,4,17049951,17050001,67,17048220,17049005,939,17049944
2507,32,32,17056810,17057327,533,17055029,17055819,985,17056804
2508,50,50,17063253,17064069,833,17061838,17062633,615,17063248
2509,10,10,17070362,17070512,167,17068664,17069447,909,17070356
2510,18,18,17077188,17077471,300,17075474,17076261,923,17077184
2511,24,24,17083998,17084381,399,17082283,17083075,917,17083992
2512,54,54,17090807,17091689,899,17089092,17089889,911,17090800
2513,58,58,17097333,17098282,966,17095918,17096703,625,17097328
2514,36,36,17104409,17104992,599,17102727,17103517,885,17104402
2515,26,26,17111201,17111618,433,17109537,17110331,865,17111196
2516,48,48,17117928,17118710,799,17116363,17117145,777,17117922
2517,34,34,17124787,17125336,566,17123172,17123959,821,17124780
2518,44,44,17131646,17132362,733,17129981,17130773,867,17131640
2519,56,56,17138505,17139421,933,17136790,17137587,913,17138500
2520,20,20,17145381,17145697,333,17143616,17144401,975,17145376
2521,54,54,17151891,17152773,899,17150426,17151215,669,17151884
2522,46,46,17158916,17159666,766,17157235,17158029,881,17158910
2523,6,6,17165809,17165892,100,17164044,17164843,961,17165804
2524,18,18,17172335,17172618,300,17170870,17171657,671,17172328
2525,36,36,17179328,17179910,599,17177679,17178471,849,17179320
2526,30,30,17186220,17186703,500,17184489,17185285,929,17186214
2527,8,8,17192713,17192830,133,17191315,17192099,609,17192708
2528,22,22,17199905,17200255,367,17198124,17198913,987,17199900
2529,2,2,17206332,17206348,33,17204933,17205727,597,17206324
2530,54,54,17213441,17214323,899,17211743,17212541,895,17213436
2531,50,50,17219867,17220683,832,17218568,17219355,505,17219860
2532,40,40,17227026,17227675,666,17225378,17226169,851,17227020
2533,56,56,17233918,17234834,933,17232187,17232983,929,17233912
2534,2,2,17240395,17240411,33,17239013,17239797,591,17240388
2535,6,6,17247570,17247654,100,17245822,17246611,953,17247564
2536,44,44,17254296,17255012,733,17252632,17253425,867,17254292
2537,30,30,17260789,17261272,500,17259441,17260239,545,17260784
2538,8,8,17267565,17267682,134,17266267,17267053,507,17267560
2539,44,44,17274574,17275290,733,17273076,17273867,701,17274568
2540,58,58,17281583,17282532,966,17279885,17280681,895,17281576
2541,6,6,17288493,17288576,100,17286711,17287495,991,17288486
2542,36,36,17295202,17295785,599,17293521,17294309,887,17295196
2543,52,52,17301845,17302694,866,17300330,17301123,717,17301840
2544,8,8,17308521,17308637,133,17307139,17307937,577,17308514
2545,6,6,17315447,17315530,100,17313965,17314751,689,17315440
2546,42,42,17322472,17323155,700,17320774,17321565,901,17322466
