TRL_TRIAL_NUMBER,TRL_USE_SSD_VR_COUNT,TRL_SSD_VR_COUNT,TRL_TARGET_TIME,TRL_STOP_SIGNAL_TIME,TRL_STOP_SIGNAL_DURATION,TRL_FIX_ON_TIME,TRL_ACQUIRE_FIX_TIME,TRL_FIX_HOLD,TRL_FIXATE_TIME
1,38,38,2552,3168,632,1070,1859,686,2545
2,56,56,9244,10160,933,7879,8673,565,9238
3,34,34,15987,16537,566,14689,15487,494,15981
4,2,2,22963,22980,33,21514,22301,655,22956
5,10,10,29739,29889,166,28324,29115,618,29733
6,30,30,36598,37081,500,35133,35929,663,36592
7,52,52,43474,44323,866,41959,42743,725,43468
8,42,42,50067,50749,699,48768,49557,503,50060
9,56,56,57309,58225,932,55578,56371,932,57303
10,56,56,63735,64651,933,62387,63185,544,63729
11,14,14,70545,70761,233,69213,69999,539,70538
12,40,40,77471,78120,665,76022,76813,651,77464
13,38,38,84313,84929,633,82831,83627,679,84306
14,54,54,91306,92188,899,89657,90441,858,91299
15,30,30,97932,98414,499,96467,97255,671,97926
16,8,8,104658,104774,133,103276,104069,582,104651
17,26,26,111817,112233,432,110085,110883,927,111810
18,10,10,118260,118409,166,116911,117697,556,118253
19,8,8,125369,125485,133,123720,124511,851,125362
20,20,20,132011,132328,333,130530,131325,680,132005
21,38,38,138854,139470,633,137356,138139,709,138848
22,6,6,145946,146030,100,144165,144953,987,145940
23,36,36,152506,153089,599,150974,151767,732,152499
24,18,18,159498,159781,300,157783,158581,911,159492
25,58,58,165958,166907,966,164609,165395,556,165951
26,8,8,172867,172984,133,171419,172209,652,172861
27,18,18,179743,180026,300,178228,179023,714,179737
28,54,54,186652,187535,899,185054,185837,809,186646
29,6,6,193628,193711,100,191863,192651,971,193622
30,26,26,200354,200770,433,198672,199465,882,200347
31,50,50,206997,207813,832,205482,206279,712,206991
32,32,32,214006,214522,533,212308,213093,907,214000
33,22,22,220815,221165,366,219117,219907,902,220809
34,26,26,227275,227691,433,225926,226721,547,227268
35,58,58,234317,235266,966,232752,233535,776,234311
36,54,54,241176,242059,899,239561,240349,821,241170
37,36,36,247703,248285,599,246371,247163,533,247696
38,14,14,254728,254945,233,253180,253977,745,254722
39,24,24,261454,261837,400,260006,260791,657,261448
40,2,2,268264,268280,33,266815,267605,652,268257
41,32,32,275156,275672,533,273625,274419,731,275150
42,8,8,282032,282149,133,280450,281233,792,282025
43,20,20,288558,288875,333,287260,288047,505,288552
44,50,50,295567,296383,833,294069,294861,700,295561
45,34,34,302360,302909,566,300878,301675,678,302353
46,6,6,309119,309203,100,307704,308489,624,309113
47,18,18,316045,316328,300,314514,315303,736,316039
48,58,58,322988,323937,965,321323,322117,865,322982
49,6,6,329780,329864,100,328132,328931,843,329774
50,56,56,336357,337272,932,334958,335745,605,336350
51,24,24,343549,343932,399,341767,342559,983,343542
52,24,24,350008,350391,400,348577,349373,629,350002
53,42,42,356934,357617,700,355403,356187,741,356928
54,26,26,363610,364027,433,362212,363001,603,363604
55,50,50,370786,371602,832,369021,369815,965,370780
56,28,28,377595,378045,466,375830,376629,960,377589
57,30,30,384421,384904,500,382656,383443,972,384415
58,30,30,391114,391597,499,389466,390257,851,391108
59,36,36,397707,398289,599,396275,397071,629,397700
60,2,2,404849,404866,33,403101,403885,958,404843
61,26,26,411309,411725,433,409910,410699,603,411302
62,58,58,418268,419217,965,416719,417513,748,418261
63,2,2,425144,425160,33,423529,424327,811,425138
64,54,54,432103,432985,899,430355,431141,956,432097
65,50,50,438496,439312,832,437164,437955,534,438489
66,2,2,445372,445388,33,443973,444769,596,445365
67,24,24,452464,452847,400,450799,451583,875,452458
68,60,60,458940,459923,999,457608,458397,536,458933
69,16,16,465766,466016,267,464418,465211,549,465760
70,44,44,472559,473275,732,471227,472025,527,472552
71,58,58,479801,480750,966,478053,478839,956,479795
72,54,54,486594,487476,899,484862,485653,934,486587
73,48,48,493453,494235,799,491672,492467,980,493447
74,56,56,499963,500878,932,498497,499281,675,499956
75,24,24,506672,507055,400,505307,506095,571,506666
76,30,30,513481,513964,500,512116,512909,566,513475
77,42,42,520274,520956,699,518925,519723,544,520267
78,30,30,527083,527566,500,525751,526537,539,527076
79,26,26,534209,534625,433,532561,533351,852,534203
80,50,50,540752,541567,832,539370,540165,580,540745
81,4,4,547661,547711,66,546196,546979,676,547655
82,56,56,554553,555469,933,553005,553793,754,554547
83,40,40,561180,561829,665,559814,560607,566,561173
84,36,36,568055,568638,600,566624,567421,628,568049
85,44,44,574798,575514,733,573450,574235,557,574792
86,4,4,581874,581924,66,580259,581049,819,581868
87,40,40,588833,589482,666,587068,587863,964,588827
88,4,4,595226,595276,67,593894,594677,542,595219
89,42,42,602152,602834,699,600703,601491,654,602145
90,6,6,609211,609294,100,607513,608305,900,609205
91,36,36,615887,616470,599,614322,615119,762,615881
92,16,16,622663,622913,266,621148,621933,724,622657
93,60,60,629539,630521,999,627957,628747,785,629532
94,8,8,636365,636481,133,634766,635561,797,636358
95,48,48,643024,643807,799,641592,642375,642,643017
96,46,46,649850,650599,766,648402,649189,655,649844
97,28,28,656759,657209,466,655211,656003,750,656753
98,40,40,663335,663985,666,662020,662817,512,663329
99,34,34,670228,670777,566,668846,669631,590,670221
100,60,60,677154,678136,999,675655,676445,702,677147
101,2,2,683896,683913,34,682465,683259,631,683890
102,22,22,690573,690922,366,689274,690073,493,690566
103,60,60,697565,698547,999,696100,696887,672,697559
104,52,52,704224,705074,866,702909,703701,517,704218
105,22,22,711500,711850,366,709719,710515,979,711494
106,60,60,718026,719008,999,716544,717329,690,718019
107,24,24,724919,725302,399,723354,724143,770,724913
108,12,12,731845,732028,199,730163,730957,881,731838
109,56,56,738304,739220,933,736972,737771,526,738297
110,58,58,745163,746112,966,743798,744585,572,745157
111,56,56,752356,753271,932,750608,751399,951,752350
112,26,26,758715,759132,433,757417,758213,496,758709
113,48,48,765658,766440,799,764243,765027,625,765652
114,22,22,772717,773067,366,771052,771841,870,772711
115,4,4,779410,779460,66,777861,778655,748,779403
116,50,50,786219,787035,832,784671,785469,744,786213
117,58,58,792862,793811,965,791497,792283,573,792856
118,56,56,799804,800720,933,798306,799097,701,799798
119,58,58,806647,807596,965,805115,805911,729,806640
120,24,24,813556,813939,400,811941,812725,825,813550
121,28,28,820066,820515,466,818750,819539,520,820059
122,20,20,827274,827591,333,825560,826353,916,827269
123,12,12,833984,834167,200,832369,833167,811,833978
124,42,42,840543,841226,700,839195,839981,556,840537
125,48,48,847336,848118,799,846004,846795,534,847329
126,42,42,854362,855044,699,852813,853609,746,854355
127,6,6,860921,861005,100,859639,860423,491,860914
128,46,46,868080,868829,766,866449,867237,837,868074
129,56,56,874756,875672,933,873258,874051,699,874750
130,8,8,881432,881549,134,880067,880865,561,881426
131,36,36,888325,888908,599,886893,887679,639,888318
132,54,54,895434,896316,899,893702,894493,934,895427
133,24,24,901894,902276,399,900512,901307,580,901887
134,36,36,908953,909535,599,907338,908121,826,908947
135,46,46,915912,916661,766,914147,914935,971,915906
136,56,56,922338,923254,932,920956,921749,582,922331
137,6,6,929231,929314,99,927765,928563,661,929224
138,60,60,936090,937072,999,934591,935377,706,936083
139,52,52,943066,943915,865,941401,942191,869,943060
140,40,40,949875,950524,666,948210,949005,864,949869
141,44,44,956568,957283,732,955036,955819,742,956561
142,56,56,963144,964059,932,961845,962633,504,963137
143,32,32,970170,970686,532,968654,969447,716,970163
144,50,50,976779,977595,832,975464,976261,512,976773
145,46,46,983905,984654,765,982290,983075,824,983899
146,8,8,990497,990614,134,989099,989889,602,990491
147,40,40,997240,997889,666,995908,996703,530,997233
148,52,52,1004283,1005132,865,1002734,1003517,759,1004276
149,60,60,1011042,1012024,999,1009544,1010331,705,1011036
150,26,26,1017818,1018234,433,1016353,1017145,667,1017812
151,54,54,1024577,1025460,899,1023162,1023959,612,1024571
152,52,52,1031420,1032269,866,1029988,1030773,640,1031413
153,50,50,1038096,1038912,832,1036797,1037587,502,1038089
154,56,56,1045105,1046021,932,1043607,1044401,698,1045099
155,38,38,1052063,1052679,633,1050432,1051215,842,1052057
156,4,4,1058556,1058606,67,1057241,1058029,521,1058550
157,52,52,1065365,1066214,866,1064050,1064843,516,1065359
158,26,26,1072308,1072724,433,1070859,1071657,644,1072301
159,48,48,1079167,1079950,799,1077685,1078471,689,1079160
160,48,48,1086159,1086942,800,1084495,1085285,869,1086154
161,58,58,1092602,1093551,966,1091304,1092099,497,1092596
162,32,32,1099778,1100294,533,1098130,1098913,859,1099772
163,20,20,1106554,1106870,333,1104939,1105727,821,1106548
164,20,20,1113247,1113563,333,1111748,1112541,699,1113240
165,16,16,1120289,1120539,267,1118558,1119355,928,1120283
166,14,14,1126732,1126949,233,1125384,1126169,557,1126726
167,50,50,1133575,1134391,832,1132193,1132983,585,1133568
168,12,12,1140334,1140517,200,1139002,1139797,530,1140327
169,44,44,1147227,1147942,732,1145828,1146611,609,1147220
170,10,10,1153936,1154086,166,1152637,1153425,504,1153929
171,46,46,1160845,1161594,766,1159447,1160239,600,1160839
172,28,28,1168054,1168504,466,1166256,1167053,995,1168048
173,2,2,1174863,1174880,34,1173082,1173867,990,1174857
174,52,52,1181240,1182089,865,1179891,1180681,552,1181233
175,46,46,1188465,1189214,766,1186700,1187495,964,1188459
176,12,12,1195241,1195424,200,1193526,1194309,926,1195235
177,14,14,1201734,1201951,233,1200336,1201123,605,1201728
178,58,58,1208543,1209492,966,1207145,1207937,600,1208537
179,6,6,1215270,1215353,99,1213954,1214751,512,1215263
180,46,46,1222212,1222961,766,1220780,1221565,640,1222205
181,10,10,1229271,1229421,167,1227589,1228379,885,1229264
182,54,54,1235881,1236763,899,1234399,1235193,681,1235874
183,30,30,1242940,1243422,499,1241208,1242007,926,1242933
184,28,28,1249666,1250115,466,1248034,1248821,838,1249659
185,36,36,1256525,1257107,599,1254843,1255635,883,1256518
186,4,4,1263251,1263301,66,1261653,1262449,796,1263245
187,2,2,1270143,1270160,34,1268478,1269263,874,1270137
188,8,8,1277053,1277169,133,1275288,1276077,970,1277047
189,12,12,1283745,1283928,200,1282097,1282891,848,1283739
190,32,32,1290688,1291204,533,1288906,1289705,976,1290681
191,14,14,1297281,1297497,233,1295732,1296519,755,1297274
192,4,4,1304290,1304340,66,1302542,1303333,951,1304284
193,20,20,1310866,1311182,333,1309351,1310147,713,1310860
194,26,26,1317459,1317875,433,1316177,1316961,491,1317452
195,34,34,1324551,1325100,566,1322986,1323775,770,1324545
196,6,6,1331510,1331593,100,1329795,1330589,915,1331504
197,60,60,1338253,1339235,999,1336605,1337403,844,1338247
198,12,12,1345212,1345395,200,1343431,1344217,989,1345206
199,44,44,1351888,1352604,733,1350240,1351031,851,1351882
200,34,34,1358631,1359180,566,1357049,1357845,779,1358624
201,10,10,1365174,1365324,166,1363875,1364659,508,1365167
202,20,20,1372066,1372383,333,1370684,1371473,586,1372059
203,24,24,1378859,1379242,399,1377494,1378287,566,1378853
204,12,12,1385701,1385885,200,1384303,1385101,594,1385695
205,46,46,1392727,1393476,766,1391129,1391915,806,1392721
206,44,44,1399536,1400252,733,1397938,1398729,801,1399530
207,4,4,1406529,1406579,66,1404747,1405543,979,1406522
208,2,2,1413288,1413305,34,1411573,1412357,925,1413282
209,32,32,1419848,1420364,533,1418383,1419171,671,1419842
210,26,26,1426690,1427107,433,1425192,1425985,699,1426684
211,54,54,1433749,1434632,899,1432001,1432799,944,1433743
212,54,54,1440376,1441258,899,1438827,1439613,756,1440369
213,12,12,1447168,1447351,200,1445636,1446427,734,1447161
214,10,10,1453811,1453961,166,1452446,1453241,564,1453805
215,14,14,1460637,1460853,233,1459272,1460055,576,1460631
216,22,22,1467713,1468062,366,1466081,1466869,837,1467706
217,4,4,1474189,1474239,66,1472890,1473683,499,1474182
218,58,58,1480998,1481947,966,1479700,1480497,495,1480992
219,6,6,1488007,1488090,100,1486525,1487311,689,1488000
220,60,60,1494750,1495732,999,1493335,1494125,619,1494744
221,48,48,1501692,1502475,800,1500144,1500939,747,1501686
222,28,28,1508701,1509151,467,1506970,1507753,942,1508695
223,54,54,1515244,1516127,899,1513779,1514567,671,1515238
224,58,58,1521970,1522919,966,1520589,1521381,583,1521964
225,24,24,1529196,1529579,399,1527398,1528195,995,1529190
226,46,46,1535622,1536371,766,1534224,1535009,607,1535616
227,40,40,1542448,1543097,666,1541033,1541823,619,1542442
228,12,12,1549307,1549491,200,1547842,1548637,664,1549301
229,2,2,1556200,1556217,33,1554668,1555451,742,1556193
230,30,30,1562893,1563376,499,1561478,1562265,622,1562887
231,56,56,1569719,1570634,932,1568287,1569079,633,1569712
232,14,14,1576794,1577011,233,1575096,1575893,895,1576788
233,26,26,1583371,1583787,432,1581922,1582707,657,1583364
234,38,38,1590163,1590779,633,1588731,1589521,635,1590156
235,38,38,1596972,1597588,633,1595541,1596335,631,1596966
236,58,58,1603798,1604747,966,1602367,1603149,643,1603792
237,14,14,1610757,1610974,234,1609176,1609963,788,1610751
238,18,18,1617667,1617950,299,1615985,1616777,883,1617660
239,16,16,1624260,1624509,266,1622794,1623591,662,1624253
240,28,28,1631102,1631552,466,1629620,1630405,690,1631095
241,28,28,1637911,1638361,467,1636430,1637219,686,1637905
242,32,32,1644837,1645353,533,1643239,1644033,798,1644831
243,46,46,1651430,1652179,766,1650048,1650847,576,1651423
244,44,44,1658622,1659338,733,1656874,1657661,955,1658616
245,54,54,1665448,1666331,899,1663683,1664475,967,1665442
246,56,56,1671925,1672840,932,1670493,1671289,629,1671918
247,46,46,1678917,1679666,766,1677319,1678103,808,1678911
248,50,50,1685427,1686242,832,1684128,1684917,503,1685420
249,30,30,1692569,1693052,499,1690937,1691731,831,1692562
250,48,48,1699128,1699911,800,1697747,1698545,577,1699122
251,32,32,1706071,1706587,533,1704572,1705359,705,1706064
252,16,16,1712764,1713013,266,1711382,1712173,584,1712757
253,20,20,1719556,1719873,333,1718191,1718987,563,1719550
254,54,54,1726499,1727381,899,1725017,1725801,691,1726492
255,6,6,1733491,1733574,100,1731826,1732615,870,1733485
256,6,6,1740417,1740500,100,1738636,1739429,982,1740411
257,4,4,1747193,1747243,67,1745445,1746243,944,1747187
258,50,50,1753603,1754418,832,1752271,1753057,539,1753596
259,42,42,1760595,1761278,699,1759080,1759871,718,1760589
260,26,26,1767454,1767871,433,1765889,1766685,763,1767448
261,58,58,1774330,1775279,966,1772715,1773499,825,1774324
262,36,36,1780806,1781389,600,1779525,1780313,487,1780800
263,20,20,1787699,1788015,333,1786334,1787127,566,1787693
264,24,24,1794841,1795224,400,1793143,1793941,894,1794835
265,34,34,1801467,1802017,566,1799969,1800755,706,1801461
266,10,10,1808493,1808643,167,1806778,1807569,918,1808487
267,2,2,1815169,1815186,34,1813588,1814383,780,1815163
268,46,46,1822095,1822844,766,1820414,1821197,892,1822089
269,44,44,1828888,1829604,732,1827223,1828011,871,1828882
270,52,52,1835431,1836280,865,1834032,1834825,599,1835424
271,54,54,1842323,1843206,899,1840841,1841639,677,1842316
272,60,60,1849166,1850148,999,1847667,1848453,706,1849159
273,28,28,1855858,1856308,467,1854477,1855267,585,1855852
274,30,30,1863051,1863533,499,1861286,1862081,964,1863045
275,34,34,1869410,1869960,567,1868112,1868895,509,1869404
276,40,40,1876653,1877302,666,1874921,1875709,937,1876646
277,52,52,1883512,1884361,866,1881730,1882523,982,1883505
278,32,32,1890088,1890604,533,1888540,1889337,745,1890082
279,24,24,1896981,1897363,399,1895366,1896151,824,1896975
280,30,30,1903840,1904323,499,1902175,1902965,869,1903834
281,8,8,1910483,1910599,133,1908984,1909779,697,1910476
282,16,16,1917558,1917808,267,1915810,1916593,959,1917552
283,22,22,1924134,1924484,367,1922619,1923407,721,1924128
284,46,46,1930811,1931560,765,1929429,1930221,583,1930804
285,4,4,1937953,1938003,66,1936238,1937035,912,1937947
286,2,2,1944712,1944729,33,1943064,1943849,857,1944706
287,40,40,1951471,1952121,666,1949873,1950663,802,1951465
288,28,28,1958148,1958597,466,1956683,1957477,665,1958142
289,48,48,1964924,1965706,799,1963508,1964291,626,1964917
290,6,6,1972049,1972132,100,1970318,1971105,938,1972043
291,28,28,1978625,1979075,467,1977127,1977919,700,1978619
292,42,42,1985451,1986134,700,1983936,1984733,712,1985445
293,6,6,1992311,1992394,99,1990762,1991547,757,1992304
294,26,26,1999320,1999736,433,1997572,1998361,953,1999314
295,32,32,2005912,2006429,533,2004381,2005175,731,2005906
296,36,36,2012655,2013238,600,2011190,2011989,660,2012649
297,30,30,2019514,2019997,500,2018016,2018803,705,2019508
298,2,2,2026307,2026324,33,2024825,2025617,683,2026300
299,4,4,2033083,2033133,67,2031635,2032431,646,2033077
300,8,8,2039976,2040092,133,2038461,2039245,725,2039970
301,6,6,2046668,2046752,100,2045270,2046059,603,2046662
302,28,28,2053661,2054110,466,2052079,2052873,781,2053654
303,26,26,2060187,2060603,433,2058888,2059687,493,2060180
304,16,16,2067346,2067596,266,2065714,2066501,838,2067339
305,48,48,2074305,2075088,799,2072524,2073315,984,2074299
306,36,36,2080631,2081214,600,2079333,2080129,496,2080625
307,10,10,2087857,2088007,166,2086159,2086943,908,2087851
308,24,24,2094333,2094716,400,2092968,2093757,570,2094327
309,38,38,2101176,2101792,633,2099777,2100571,598,2101169
310,56,56,2108002,2108917,932,2106587,2107385,611,2107996
311,48,48,2114828,2115610,799,2113413,2114199,623,2114822
312,12,12,2121804,2121987,199,2120222,2121013,784,2121797
313,14,14,2128779,2128996,233,2127031,2127827,946,2128773
314,52,52,2135172,2136021,866,2133857,2134641,525,2135166
315,42,42,2142082,2142764,699,2140666,2141455,620,2142075
316,60,60,2149124,2150106,999,2147476,2148269,849,2149118
317,40,40,2155634,2156283,665,2154285,2155083,544,2155627
318,52,52,2162443,2163292,866,2161111,2161897,539,2162436
319,30,30,2169685,2170168,499,2167920,2168711,968,2169679
320,2,2,2176411,2176428,33,2174729,2175525,879,2176404
321,38,38,2183037,2183653,633,2181555,2182339,691,2183030
322,10,10,2189863,2190013,167,2188365,2189153,704,2189857
323,18,18,2196772,2197055,300,2195174,2195967,799,2196766
324,18,18,2203348,2203631,300,2201983,2202781,561,2203342
325,16,16,2210574,2210824,266,2208809,2209595,973,2210568
326,28,28,2217217,2217666,466,2215619,2216409,802,2217211
327,4,4,2223843,2223893,67,2222428,2223223,614,2223837
328,2,2,2230686,2230702,33,2229254,2230037,642,2230679
329,24,24,2237428,2237811,400,2236063,2236851,571,2237422
330,58,58,2244337,2245286,966,2242872,2243665,666,2244331
331,32,32,2251097,2251613,532,2249682,2250479,612,2251091
332,28,28,2257956,2258405,466,2256508,2257293,657,2257950
333,4,4,2264699,2264749,66,2263317,2264107,585,2264692
334,26,26,2271774,2272191,433,2270126,2270921,847,2271768
335,34,34,2278584,2279133,566,2276952,2277735,842,2278577
336,4,4,2285160,2285210,66,2283761,2284549,604,2285153
337,2,2,2292202,2292219,33,2290571,2291363,833,2292196
338,14,14,2298778,2298995,233,2297380,2298177,595,2298772
339,50,50,2305737,2306553,833,2304206,2304991,740,2305731
340,48,48,2312747,2313529,799,2311015,2311805,935,2312740
341,16,16,2319606,2319856,266,2317824,2318619,980,2319599
342,52,52,2326115,2326964,866,2324650,2325433,676,2326109
343,4,4,2332758,2332808,67,2331460,2332247,505,2332752
344,8,8,2339884,2340000,133,2338269,2339061,817,2339878
345,30,30,2346493,2346976,500,2345078,2345875,612,2346487
346,28,28,2353402,2353852,467,2351904,2352689,707,2353396
347,58,58,2360012,2360961,966,2358713,2359503,502,2360005
348,6,6,2367271,2367354,100,2365523,2366317,948,2367265
349,4,4,2373997,2374047,66,2372332,2373131,860,2373991
350,28,28,2380756,2381206,466,2379158,2379945,805,2380750
351,8,8,2387732,2387848,133,2385967,2386759,967,2387726
352,48,48,2394475,2395257,799,2392776,2393573,895,2394468
353,50,50,2401018,2401833,832,2399602,2400387,624,2401011
354,34,34,2408160,2408709,566,2406412,2407201,953,2408154
355,48,48,2414603,2415385,799,2413221,2414015,581,2414596
356,44,44,2421678,2422394,733,2420030,2420829,843,2421672
357,12,12,2428288,2428471,200,2426856,2427643,638,2428281
358,56,56,2435347,2436263,932,2433665,2434457,883,2435340
359,56,56,2442190,2443105,932,2440475,2441271,913,2442184
360,42,42,2448932,2449615,700,2447301,2448085,841,2448926
361,60,60,2455841,2456824,999,2454110,2454899,936,2455835
362,40,40,2462667,2463317,666,2460919,2461713,948,2462661
363,44,44,2469510,2470226,733,2467729,2468527,977,2469504
364,48,48,2475870,2476652,799,2474554,2475341,522,2475863
365,48,48,2482779,2483561,799,2481364,2482155,618,2482773
366,56,56,2489688,2490604,932,2488173,2488969,713,2489682
367,50,50,2496564,2497380,832,2494999,2495783,775,2496558
368,22,22,2503373,2503723,367,2501808,2502597,770,2503367
369,56,56,2510349,2511265,932,2508618,2509411,932,2510343
370,36,36,2516742,2517325,599,2515427,2516225,511,2516736
371,34,34,2523635,2524184,566,2522253,2523039,589,2523628
372,28,28,2530760,2531210,466,2529062,2529853,901,2530754
373,2,2,2537220,2537237,33,2535871,2536667,546,2537213
374,12,12,2544196,2544379,199,2542697,2543481,708,2544189
375,44,44,2550922,2551638,732,2549507,2550295,621,2550916
376,32,32,2557864,2558380,533,2556316,2557109,749,2557858
377,38,38,2564707,2565323,632,2563125,2563923,777,2564700
378,36,36,2571366,2571949,600,2569951,2570737,623,2571360
379,22,22,2578142,2578492,366,2576760,2577551,584,2578135
380,60,60,2585151,2586134,999,2583570,2584365,780,2585145
381,38,38,2592094,2592710,632,2590396,2591179,909,2592088
382,50,50,2598703,2599519,833,2597205,2597993,704,2598697
383,40,40,2605313,2605962,666,2604014,2604807,499,2605306
384,10,10,2612372,2612522,166,2610823,2611621,744,2612365
385,56,56,2619381,2620297,932,2617649,2618435,939,2619374
386,42,42,2625890,2626573,700,2624459,2625249,635,2625884
387,28,28,2632949,2633399,467,2631268,2632063,880,2632943
388,20,20,2639775,2640092,333,2638094,2638877,892,2639769
389,52,52,2646418,2647267,866,2644903,2645691,721,2646412
390,60,60,2653078,2654060,999,2651712,2652505,566,2653071
391,42,42,2660170,2660853,699,2658522,2659319,845,2660164
392,24,24,2666746,2667129,400,2665348,2666133,607,2666740
393,48,48,2673722,2674504,799,2672157,2672947,769,2673716
394,12,12,2680698,2680881,200,2678966,2679761,930,2680691
395,14,14,2687357,2687574,233,2685792,2686575,776,2687351
396,38,38,2694250,2694866,632,2692601,2693389,854,2694243
397,46,46,2700793,2701542,765,2699411,2700203,583,2700786
398,8,8,2707735,2707852,133,2706220,2707017,712,2707729
399,4,4,2714761,2714811,66,2713046,2713831,924,2714755
400,14,14,2721337,2721553,233,2719855,2720645,685,2721330
401,34,34,2728329,2728879,566,2726665,2727459,865,2728324
402,10,10,2734872,2735022,167,2733490,2734273,592,2734865
403,34,34,2741665,2742214,566,2740300,2741087,572,2741659
404,10,10,2748724,2748874,166,2747109,2747901,817,2748718
405,16,16,2755284,2755533,266,2753918,2754715,562,2755277
406,34,34,2762492,2763042,566,2760744,2761529,957,2762486
407,16,16,2768902,2769152,266,2767554,2768343,553,2768896
408,38,38,2775828,2776444,633,2774363,2775157,665,2775822
409,20,20,2782937,2783253,333,2781172,2781971,960,2782931
410,26,26,2789663,2790079,433,2787998,2788785,872,2789657
411,44,44,2796189,2796905,733,2794807,2795599,583,2796182
412,46,46,2803248,2803997,766,2801617,2802413,829,2803242
413,8,8,2810141,2810257,133,2808443,2809227,908,2810135
414,28,28,2816967,2817416,466,2815252,2816041,920,2816961
415,2,2,2823526,2823543,34,2822061,2822855,665,2823520
416,16,16,2830369,2830619,266,2828870,2829669,693,2830362
417,26,26,2837078,2837494,433,2835696,2836483,588,2837071
418,32,32,2844137,2844653,533,2842506,2843297,834,2844131
419,8,8,2850630,2850747,133,2849315,2850111,513,2850624
420,28,28,2857806,2858255,466,2856141,2856925,875,2857800
421,54,54,2864415,2865298,899,2862950,2863739,670,2864409
422,44,44,2871241,2871957,733,2869759,2870553,681,2871234
423,48,48,2878167,2878949,799,2876569,2877367,794,2878161
424,48,48,2884777,2885559,799,2883395,2884181,589,2884770
425,14,14,2891536,2891752,233,2890204,2890995,534,2891529
426,48,48,2898445,2899227,799,2897013,2897809,629,2898438
427,24,24,2905254,2905637,400,2903839,2904623,625,2905248
428,46,46,2912130,2912879,766,2910648,2911437,686,2912123
429,40,40,2919239,2919888,666,2917458,2918251,982,2919233
430,20,20,2925666,2925982,333,2924267,2925065,594,2925659
431,18,18,2932442,2932725,299,2931093,2931879,556,2932435
432,6,6,2939617,2939700,100,2937902,2938693,918,2939611
433,36,36,2946410,2946992,599,2944712,2945507,897,2946404
434,32,32,2952886,2953402,533,2951537,2952321,558,2952879
435,26,26,2959729,2960145,432,2958347,2959135,587,2959722
436,48,48,2966138,2966921,799,2965156,2965166,965,2966131
437,24,24,2972731,2973114,400,2971183,2971980,745,2972725
438,46,46,2979724,2980473,765,2978009,2978794,924,2979718
439,32,32,2986167,2986683,532,2984818,2985608,552,2986160
440,38,38,2993242,2993858,633,2991627,2992422,814,2993236
441,22,22,3000185,3000534,366,2998453,2999236,942,3000178
442,6,6,3006977,3007061,100,3005263,3006050,922,3006972
443,26,26,3013554,3013970,432,3012072,3012864,683,3013547
444,44,44,3020579,3021295,733,3018881,3019678,895,3020573
445,20,20,3027222,3027538,333,3025707,3026492,724,3027216
446,50,50,3034181,3034997,833,3032516,3033306,869,3034175
447,16,16,3040841,3041090,266,3039326,3040120,715,3040835
448,32,32,3047517,3048033,533,3046152,3046934,577,3047511
449,14,14,3054526,3054742,233,3052961,3053748,772,3054520
450,6,6,3061235,3061318,100,3059770,3060562,667,3061229
451,58,58,3067911,3068860,966,3066579,3067376,528,3067904
452,24,24,3075087,3075470,399,3073405,3074190,890,3075080
453,30,30,3081846,3082329,500,3080215,3081004,836,3081840
454,38,38,3088805,3089421,633,3087024,3087818,981,3088799
455,54,54,3095248,3096131,899,3093833,3094632,610,3095242
456,36,36,3102391,3102973,599,3100659,3101446,938,3102384
457,56,56,3108867,3109783,932,3107468,3108260,600,3108860
458,44,44,3115893,3116609,732,3114278,3115074,813,3115887
459,22,22,3122719,3123068,366,3121104,3121888,825,3122713
460,42,42,3129245,3129927,699,3127913,3128702,536,3129238
461,52,52,3136137,3136986,866,3134722,3135516,615,3136131
462,30,30,3142913,3143396,500,3141532,3142330,577,3142907
463,58,58,3150056,3151005,965,3148357,3149144,905,3150049
464,24,24,3156732,3157115,399,3155167,3155958,768,3156726
465,60,60,3163325,3164307,999,3161976,3162772,546,3163318
466,26,26,3170384,3170800,432,3168802,3169586,791,3170377
467,24,24,3176993,3177376,400,3175611,3176400,586,3176986
468,52,52,3184102,3184951,866,3182421,3183214,882,3184096
469,36,36,3190645,3191228,599,3189230,3190028,611,3190639
470,46,46,3197504,3198253,766,3196056,3196842,656,3197498
471,50,50,3204313,3205129,833,3202865,3203656,651,3204307
472,20,20,3211356,3211672,333,3209674,3210470,879,3211349
473,24,24,3217899,3218282,399,3216500,3217284,608,3217892
474,12,12,3225024,3225207,200,3223310,3224098,921,3225019
475,38,38,3231451,3232067,632,3230119,3230912,532,3231444
476,2,2,3238610,3238626,33,3236928,3237726,877,3238603
477,34,34,3245319,3245868,566,3243754,3244540,773,3245313
478,20,20,3252162,3252478,333,3250563,3251354,801,3252155
479,48,48,3258988,3259770,799,3257373,3258168,814,3258982
480,42,42,3265780,3266463,699,3264199,3264982,792,3265774
481,6,6,3272556,3272639,100,3271008,3271796,754,3272550
482,52,52,3279565,3280414,866,3277817,3278610,949,3279559
483,44,44,3285942,3286658,732,3284626,3285424,511,3285935
484,44,44,3293184,3293900,732,3291452,3292238,939,3293177
485,10,10,3299810,3299960,166,3298262,3299052,752,3299804
486,8,8,3306619,3306736,133,3305071,3305866,747,3306613
487,34,34,3313329,3313878,566,3311897,3312680,642,3313322
488,4,4,3320454,3320504,67,3318706,3319494,954,3320448
489,48,48,3327164,3327946,799,3325515,3326308,849,3327157
490,44,44,3333673,3334389,733,3332325,3333122,545,3333667
491,26,26,3340582,3340999,433,3339151,3339936,640,3340576
492,12,12,3347442,3347625,199,3345960,3346750,685,3347435
493,56,56,3354201,3355117,932,3352769,3353564,630,3354194
494,32,32,3361193,3361710,533,3359595,3360378,809,3361187
495,52,52,3367836,3368685,866,3366404,3367192,637,3367829
496,22,22,3374845,3375195,367,3373214,3374006,833,3374839
497,10,10,3381405,3381555,166,3380023,3380820,578,3381398
498,54,54,3388264,3389146,899,3386849,3387634,624,3388258
499,52,52,3395057,3395906,865,3393658,3394448,602,3395050
500,24,24,3402249,3402632,399,3400468,3401262,981,3402243
501,26,26,3408625,3409042,433,3407293,3408076,542,3408618
502,12,12,3415485,3415668,199,3414103,3414890,588,3415478
503,18,18,3422327,3422610,300,3420912,3421704,617,3422321
504,14,14,3429186,3429403,233,3427721,3428518,662,3429180
505,20,20,3436279,3436595,333,3434547,3435332,940,3436272
506,38,38,3442905,3443521,633,3441357,3442146,753,3442899
507,22,22,3449914,3450264,366,3448166,3448960,948,3449908
508,26,26,3456424,3456840,432,3454975,3455774,643,3456417
509,28,28,3463499,3463949,466,3461801,3462588,905,3463493
510,54,54,3470175,3471058,899,3468610,3469402,767,3470169
511,10,10,3476885,3477035,166,3475420,3476216,663,3476879
512,8,8,3483944,3484060,133,3482246,3483030,908,3483938
513,42,42,3490370,3491053,699,3489055,3489844,520,3490364
514,48,48,3497296,3498078,799,3495864,3496658,631,3497289
515,16,16,3504022,3504272,266,3502673,3503472,543,3504015
516,22,22,3511181,3511530,366,3509499,3510286,888,3511174
517,6,6,3517957,3518040,100,3516309,3517100,851,3517951
518,26,26,3524799,3525216,433,3523118,3523914,879,3524793
519,54,54,3531692,3532574,899,3529944,3530728,958,3531686
520,34,34,3538401,3538951,566,3536753,3537542,853,3538395
521,44,44,3545277,3545993,733,3543562,3544356,915,3545271
522,14,14,3551953,3552170,233,3550372,3551170,777,3551947
523,56,56,3558729,3559645,933,3557198,3557984,739,3558723
524,10,10,3565389,3565539,166,3564007,3564798,584,3565382
525,12,12,3572548,3572731,199,3570816,3571612,929,3572541
526,2,2,3579240,3579257,34,3577642,3578426,808,3579234
527,8,8,3586050,3586166,133,3584451,3585240,803,3586043
528,14,14,3592876,3593092,233,3591261,3592054,816,3592870
529,50,50,3599585,3600401,832,3598070,3598868,711,3599579
530,24,24,3606478,3606860,399,3604896,3605682,789,3606471
531,46,46,3613470,3614219,766,3611705,3612496,968,3613464
532,10,10,3620229,3620379,167,3618514,3619310,913,3620223
533,32,32,3626939,3627455,532,3625340,3626124,808,3626932
534,12,12,3633715,3633898,199,3632150,3632938,771,3633709
535,60,60,3640541,3641523,999,3638959,3639752,782,3640534
536,20,20,3647433,3647749,333,3645768,3646566,861,3647427
537,56,56,3654009,3654925,933,3652594,3653380,623,3654003
538,48,48,3660869,3661651,799,3659404,3660194,669,3660863
539,50,50,3667794,3668610,833,3666213,3667008,780,3667788
540,60,60,3674737,3675719,999,3673039,3673822,909,3674731
541,16,16,3681613,3681862,266,3679848,3680636,971,3681607
542,18,18,3688389,3688672,299,3686657,3687450,932,3688382
543,26,26,3694349,3694765,433,3693467,3693481,861,3694342
544,52,52,3700958,3701808,866,3699510,3700295,657,3700952
545,56,56,3707651,3708567,933,3706319,3707109,535,3707644
546,36,36,3714877,3715459,599,3713129,3713923,948,3714871
547,12,12,3721286,3721470,200,3719955,3720737,543,3721280
548,22,22,3728079,3728429,366,3726764,3727551,522,3728073
549,34,34,3734972,3735521,566,3733573,3734365,600,3734965
550,16,16,3741964,3742214,266,3740382,3741179,778,3741957
551,30,30,3748657,3749140,499,3747208,3747993,657,3748650
552,38,38,3755583,3756199,632,3754018,3754807,770,3755577
553,56,56,3762309,3763224,932,3760827,3761621,681,3762302
554,16,16,3769318,3769567,266,3767636,3768435,876,3769311
555,60,60,3776044,3777026,999,3774462,3775249,788,3776037
556,8,8,3782687,3782803,133,3781271,3782063,617,3782680
557,24,24,3789413,3789795,399,3788081,3788877,529,3789406
558,50,50,3795772,3796588,833,3794907,3794908,858,3795766
559,38,38,3802598,3803214,633,3800933,3801722,870,3802592
560,30,30,3809191,3809674,500,3807743,3808536,649,3809185
561,26,26,3816234,3816650,432,3814552,3815350,877,3816227
562,36,36,3823009,3823592,600,3821378,3822164,839,3823003
563,18,18,3829952,3830235,300,3828187,3828978,968,3829946
564,28,28,3836778,3837227,466,3834997,3835792,980,3836772
565,52,52,3843121,3843970,866,3841822,3842606,508,3843114
566,46,46,3850080,3850829,766,3848632,3849420,654,3850074
567,38,38,3856873,3857489,632,3855441,3856234,632,3856866
568,54,54,3863649,3864531,899,3862250,3863048,594,3863642
569,26,26,3870458,3870874,433,3869076,3869862,589,3870451
570,16,16,3877484,3877734,266,3875886,3876676,802,3877478
571,38,38,3884043,3884659,633,3882695,3883490,547,3884037
572,26,26,3891086,3891502,433,3889521,3890304,776,3891080
573,4,4,3897862,3897912,66,3896330,3897118,737,3897855
574,30,30,3904455,3904937,499,3903139,3903932,516,3904448
575,8,8,3911630,3911747,133,3909949,3910746,878,3911624
576,40,40,3918523,3919172,666,3916775,3917560,957,3918517
577,18,18,3925332,3925615,300,3923584,3924374,952,3925326
578,58,58,3931775,3932724,966,3930393,3931188,580,3931768
579,20,20,3938651,3938967,333,3937219,3938002,642,3938644
580,48,48,3945760,3946542,799,3944028,3944816,937,3945753
581,32,32,3952586,3953102,532,3950838,3951630,950,3952580
582,46,46,3959045,3959795,766,3957647,3958444,595,3959039
583,18,18,3966038,3966321,299,3964473,3965258,774,3966032
584,58,58,3972681,3973630,965,3971282,3972072,602,3972674
585,54,54,3979723,3980605,899,3978091,3978886,830,3979716
586,38,38,3986449,3987065,633,3984917,3985700,742,3986442
587,12,12,3993391,3993575,200,3991727,3992514,872,3993386
588,52,52,4000084,4000933,866,3998536,3999328,750,4000078
589,52,52,4006993,4007842,866,4005345,4006142,845,4006987
590,16,16,4013669,4013919,267,4012171,4012956,707,4013663
591,60,60,4020562,4021544,999,4018980,4019770,785,4020555
592,24,24,4027088,4027471,400,4025790,4026584,498,4027082
593,58,58,4033997,4034946,966,4032599,4033398,593,4033991
594,48,48,4041023,4041806,799,4039425,4040212,805,4041017
595,56,56,4047699,4048615,933,4046234,4047026,667,4047693
596,42,42,4054775,4055458,699,4053043,4053840,928,4054768
597,10,10,4061418,4061568,166,4059869,4060654,757,4061411
598,30,30,4068377,4068860,499,4066679,4067468,903,4068371
599,6,6,4075269,4075353,100,4073488,4074282,981,4075263
600,4,4,4082079,4082129,66,4080297,4081096,976,4082072
601,48,48,4088472,4089254,799,4087123,4087910,555,4088465
602,32,32,4095381,4095897,533,4093932,4094724,650,4095374
603,12,12,4102540,4102723,200,4100742,4101538,996,4102534
604,18,18,4109216,4109499,300,4107568,4108352,858,4109210
605,10,10,4115809,4115959,166,4114377,4115166,636,4115802
606,44,44,4122551,4123267,733,4121186,4121980,565,4122545
607,16,16,4129377,4129627,267,4127996,4128794,577,4129371
608,48,48,4136420,4137202,799,4134822,4135608,806,4136414
609,24,24,4143212,4143595,400,4141631,4142422,784,4143206
610,8,8,4150205,4150321,133,4148440,4149236,963,4150199
611,14,14,4156914,4157131,233,4155266,4156050,858,4156908
612,8,8,4163407,4163524,133,4162075,4162864,536,4163400
613,22,22,4170266,4170616,367,4168885,4169678,582,4170260
614,48,48,4177459,4178241,799,4175694,4176492,961,4177453
615,32,32,4184051,4184568,533,4182520,4183306,739,4184045
616,60,60,4190827,4191810,999,4189329,4190120,701,4190821
617,10,10,4197554,4197703,166,4196138,4196934,613,4197547
618,28,28,4204613,4205062,466,4202964,4203748,858,4204606
619,22,22,4211072,4211422,366,4209774,4210562,504,4211066
620,46,46,4217915,4218664,766,4216583,4217376,532,4217908
621,32,32,4224791,4225307,532,4223392,4224190,594,4224784
622,60,60,4231567,4232549,999,4230218,4231004,556,4231560
623,6,6,4238709,4238792,100,4237027,4237818,884,4238702
624,28,28,4245402,4245851,466,4243837,4244632,764,4245396
625,14,14,4252327,4252544,234,4250663,4251446,876,4252322
626,12,12,4258820,4259004,200,4257472,4258260,554,4258814
627,30,30,4265780,4266262,499,4264281,4265074,699,4265773
628,54,54,4272772,4273654,899,4271090,4271888,877,4272765
629,26,26,4279681,4280097,433,4277916,4278702,973,4279675
630,60,60,4286391,4287373,998,4284726,4285516,869,4286385
631,32,32,4293100,4293616,533,4291535,4292330,764,4293094
632,32,32,4299643,4300159,533,4298361,4299144,492,4299636
633,54,54,4306685,4307568,899,4305170,4305958,721,4306679
634,24,24,4313428,4313811,399,4311979,4312772,649,4313421
635,60,60,4320187,4321170,999,4318789,4319586,595,4320181
636,16,16,4326997,4327246,266,4325615,4326400,590,4326990
637,42,42,4333789,4334472,699,4332424,4333214,569,4333783
638,52,52,4340881,4341731,866,4339233,4340028,847,4340875
639,16,16,4347558,4347807,266,4346059,4346842,709,4347551
640,44,44,4354284,4355000,732,4352868,4353656,621,4354277
641,44,44,4360993,4361709,733,4359678,4360470,517,4360987
642,22,22,4367836,4368185,366,4366487,4367284,545,4367829
643,14,14,4374595,4374811,233,4373313,4374098,490,4374588
644,2,2,4381587,4381604,34,4380122,4380912,669,4381581
645,24,24,4388230,4388613,400,4386932,4387726,498,4388224
646,2,2,4395289,4395306,33,4393757,4394540,742,4395282
647,46,46,4401982,4402731,766,4400567,4401354,622,4401976
648,50,50,4408958,4409773,832,4407376,4408168,783,4408951
649,54,54,4415967,4416849,899,4414185,4414982,978,4415960
650,60,60,4422343,4423325,999,4421011,4421796,540,4422336
651,10,10,4429435,4429585,167,4427821,4428610,820,4429430
652,48,48,4436045,4436827,799,4434630,4435424,615,4436039
653,28,28,4443187,4443637,466,4441439,4442238,943,4443181
654,44,44,4449647,4450363,732,4448265,4449052,588,4449640
655,48,48,4456789,4457572,799,4455074,4455866,917,4456783
656,52,52,4463249,4464098,866,4461884,4462680,563,4463243
657,10,10,4470158,4470308,167,4468710,4469494,658,4470152
658,36,36,4477051,4477633,599,4475519,4476308,736,4477044
659,60,60,4483976,4484959,999,4482328,4483122,848,4483970
660,54,54,4490719,4491601,899,4489137,4489936,776,4490712
661,50,50,4497428,4498244,833,4495963,4496750,672,4497422
662,10,10,4504421,4504571,166,4502773,4503564,851,4504415
663,12,12,4511080,4511263,200,4509582,4510378,696,4511074
664,10,10,4518123,4518273,166,4516408,4517192,925,4518117
665,34,34,4524516,4525065,566,4523217,4524006,503,4524509
666,54,54,4531775,4532657,899,4530026,4530820,948,4531768
667,18,18,4538384,4538667,300,4536836,4537634,744,4538378
668,58,58,4545044,4545992,965,4543662,4544448,589,4545037
669,2,2,4552086,4552103,33,4550471,4551262,818,4552080
670,60,60,4559028,4560011,999,4557280,4558076,946,4559022
671,50,50,4565804,4566620,833,4564106,4564890,908,4565798
672,20,20,4572447,4572763,333,4570915,4571704,736,4572440
673,22,22,4579206,4579556,367,4577725,4578518,682,4579200
674,46,46,4586216,4586965,765,4584534,4585332,877,4586209
675,28,28,4592792,4593241,466,4591360,4592146,639,4592785
676,52,52,4599651,4600500,866,4598169,4598960,684,4599644
677,44,44,4606394,4607110,732,4604979,4605774,614,4606388
678,46,46,4613436,4614185,766,4611804,4612588,841,4613429
679,16,16,4620095,4620345,267,4618614,4619402,687,4620089
680,48,48,4627038,4627820,799,4625423,4626216,816,4627032
681,34,34,4633681,4634230,566,4632232,4633030,644,4633674
682,36,36,4640523,4641106,600,4639058,4639844,673,4640517
683,42,42,4647549,4648232,699,4645868,4646658,885,4647543
684,14,14,4654425,4654641,233,4652677,4653472,947,4654419
685,24,24,4661168,4661551,399,4659503,4660286,876,4661162
686,20,20,4667927,4668243,333,4666312,4667100,821,4667921
687,42,42,4674487,4675169,699,4673121,4673914,566,4674480
688,16,16,4681629,4681879,266,4679931,4680728,895,4681623
689,34,34,4688238,4688788,566,4686757,4687542,690,4688232
690,42,42,4695014,4695697,700,4693566,4694356,652,4695008
691,6,6,4701774,4701857,100,4700375,4701170,597,4701767
692,4,4,4708799,4708849,67,4707201,4707984,809,4708793
693,24,24,4715642,4716025,400,4714010,4714798,837,4715635
694,36,36,4722152,4722734,599,4720820,4721612,533,4722145
695,12,12,4728545,4728728,199,4727629,4727643,895,4728538
696,38,38,4734988,4735604,632,4733672,4734457,524,4734981
697,28,28,4742230,4742679,466,4740482,4741271,953,4742224
698,38,38,4749022,4749638,633,4747291,4748085,931,4749016
699,22,22,4755798,4756148,367,4754100,4754899,893,4755792
700,16,16,4762708,4762957,266,4760926,4761713,988,4762701
701,44,44,4769051,4769767,732,4767735,4768527,517,4769044
702,2,2,4776226,4776243,34,4774545,4775341,879,4776220
703,24,24,4782986,4783369,399,4781371,4782155,825,4782980
704,30,30,4789762,4790244,499,4788180,4788969,786,4789755
705,44,44,4796538,4797253,732,4794989,4795783,748,4796531
706,12,12,4803463,4803647,200,4801799,4802597,861,4803458
707,56,56,4810090,4811005,932,4808624,4809411,672,4810083
708,10,10,4816832,4816982,167,4815434,4816225,601,4816826
709,26,26,4823875,4824291,432,4822243,4823039,829,4823868
710,26,26,4830567,4830984,433,4829069,4829853,708,4830561
711,22,22,4837626,4837976,367,4835878,4836667,953,4837620
712,12,12,4844053,4844236,200,4842688,4843481,566,4844047
713,38,38,4850945,4851561,633,4849497,4850295,644,4850939
714,48,48,4857688,4858470,799,4856323,4857109,573,4857682
715,56,56,4864880,4865796,932,4863132,4863923,951,4864874
716,22,22,4871689,4872039,367,4869941,4870737,946,4871683
717,50,50,4878216,4879031,832,4876767,4877551,658,4878209
718,2,2,4885358,4885375,33,4883577,4884365,987,4885352
719,48,48,4892151,4892933,799,4890386,4891179,966,4892145
720,56,56,4898627,4899543,932,4897195,4897993,627,4898620
721,60,60,4905802,4906785,999,4904021,4904807,989,4905796
722,14,14,4912578,4912795,234,4910830,4911621,951,4912572
723,52,52,4919438,4920287,865,4917640,4918435,997,4919432
724,60,60,4926064,4927046,999,4924466,4925249,809,4926058
725,36,36,4932840,4933423,599,4931275,4932063,771,4932834
726,16,16,4939632,4939882,267,4938084,4938877,749,4939626
727,24,24,4946508,4946891,400,4944893,4945691,811,4946502
728,28,28,4953451,4953900,466,4951719,4952505,939,4953444
729,46,46,4960260,4961009,766,4958529,4959319,935,4960254
730,56,56,4966770,4967685,932,4965338,4966133,630,4966763
731,24,24,4973912,4974295,400,4972164,4972947,959,4973906
732,14,14,4980538,4980755,233,4978973,4979761,771,4980532
733,34,34,4987431,4987980,566,4985782,4986575,849,4987424
734,14,14,4994123,4994340,233,4992592,4993389,728,4994117
735,46,46,5000933,5001682,766,4999418,5000203,724,5000927
736,28,28,5007908,5008358,467,5006227,5007017,885,5007902
737,46,46,5014351,5015101,766,5013036,5013831,514,5014345
738,50,50,5021410,5022226,833,5019862,5020645,759,5021404
739,10,10,5028170,5028320,166,5026671,5027459,704,5028163
740,10,10,5035262,5035412,167,5033481,5034273,983,5035256
741,34,34,5041972,5042521,566,5040290,5041087,878,5041965
742,30,30,5048814,5049297,500,5047116,5047901,907,5048808
743,10,10,5055623,5055773,167,5053925,5054715,902,5055617
744,30,30,5062100,5062583,499,5060735,5061529,565,5062094
745,36,36,5069309,5069891,599,5067560,5068343,959,5069302
746,56,56,5075868,5076784,932,5074370,5075157,705,5075862
747,18,18,5082711,5082994,299,5081179,5081971,733,5082704
748,52,52,5089320,5090169,866,5087988,5088785,528,5089313
749,40,40,5096429,5097078,666,5094814,5095599,824,5096423
750,16,16,5103372,5103621,266,5101624,5102413,953,5103366
751,6,6,5110181,5110264,100,5108433,5109227,948,5110175
752,10,10,5116624,5116774,166,5115242,5116041,576,5116617
753,18,18,5123800,5124083,299,5122068,5122855,938,5123793
754,50,50,5130259,5131075,833,5128877,5129669,583,5130252
755,54,54,5137019,5137901,899,5135687,5136483,529,5137012
756,44,44,5143844,5144560,733,5142513,5143297,541,5143838
757,30,30,5150870,5151353,500,5149322,5150111,753,5150864
758,58,58,5157563,5158512,966,5156131,5156925,631,5157556
759,42,42,5164689,5165371,699,5162940,5163739,943,5164682
760,38,38,5171215,5171831,632,5169766,5170553,655,5171208
761,16,16,5178157,5178407,267,5176576,5177367,784,5178151
762,42,42,5184917,5185599,699,5183385,5184181,729,5184910
763,52,52,5191809,5192658,866,5190211,5190995,808,5191803
764,14,14,5198702,5198918,233,5197020,5197809,886,5198695
765,16,16,5205311,5205561,267,5203829,5204623,681,5205304
766,34,34,5212187,5212736,566,5210639,5211437,744,5212181
767,24,24,5218980,5219363,399,5217465,5218251,723,5218974
768,34,34,5225922,5226472,566,5224274,5225065,851,5225916
769,22,22,5232582,5232931,366,5231083,5231879,696,5232575
770,52,52,5239224,5240073,866,5237909,5238693,525,5239218
771,20,20,5246417,5246733,333,5244718,5245507,903,5246410
772,12,12,5253093,5253276,199,5251528,5252321,766,5253087
773,32,32,5259869,5260385,532,5258337,5259135,727,5259862
774,8,8,5266944,5267061,134,5265163,5265949,989,5266938
775,2,2,5273554,5273570,33,5271972,5272763,784,5273547
776,26,26,5280180,5280596,433,5278782,5279577,597,5280174
777,26,26,5287306,5287722,432,5285607,5286391,908,5287299
778,54,54,5293765,5294648,899,5292417,5293205,554,5293759
779,24,24,5300558,5300941,399,5299226,5300019,532,5300551
780,38,38,5307467,5308083,633,5306035,5306833,627,5307460
781,4,4,5314260,5314310,66,5312861,5313647,606,5314253
782,44,44,5321252,5321968,733,5319671,5320461,785,5321246
783,60,60,5328228,5329210,999,5326480,5327275,947,5328222
784,56,56,5334854,5335770,932,5333306,5334089,759,5334848
785,2,2,5341464,5341480,33,5340115,5340903,554,5341457
786,28,28,5348339,5348789,467,5346924,5347717,616,5348333
787,46,46,5355415,5356164,766,5353734,5354531,878,5355409
788,16,16,5362191,5362441,266,5360560,5361345,840,5362185
789,22,22,5368934,5369283,366,5367369,5368159,769,5368928
790,34,34,5375843,5376392,566,5374178,5374973,864,5375837
791,56,56,5382369,5383285,933,5381004,5381787,576,5382363
792,12,12,5389595,5389778,200,5387813,5388601,987,5389588
793,24,24,5395988,5396371,399,5394623,5395415,567,5395982
794,26,26,5403163,5403580,433,5401432,5402229,928,5403157
795,14,14,5409806,5410023,233,5408258,5409043,757,5409800
796,6,6,5416615,5416699,100,5415067,5415857,752,5416609
797,28,28,5423292,5423741,466,5421876,5422671,614,5423285
798,6,6,5430400,5430484,100,5428702,5429485,909,5430394
799,20,20,5437127,5437443,333,5435512,5436299,822,5437121
800,2,2,5443819,5443836,34,5442321,5443113,700,5443813
801,22,22,5450495,5450845,367,5449130,5449927,562,5450489
802,30,30,5457305,5457787,499,5455956,5456741,557,5457298
803,4,4,5464497,5464547,66,5462765,5463555,935,5464490
804,12,12,5471306,5471489,200,5469575,5470369,931,5471300
805,4,4,5477866,5477916,66,5476384,5477183,676,5477859
806,20,20,5484808,5485125,333,5483210,5483997,805,5484802
807,6,6,5491318,5491401,100,5490019,5490811,500,5491311
808,20,20,5498160,5498477,333,5496828,5497625,528,5498153
809,50,50,5505169,5505985,833,5503654,5504439,724,5505163
810,16,16,5511995,5512245,267,5510464,5511253,736,5511989
811,18,18,5518638,5518921,300,5517273,5518067,565,5518632
812,20,20,5525564,5525880,333,5524082,5524881,676,5525557
813,30,30,5532390,5532873,499,5530908,5531695,688,5532383
814,2,2,5539233,5539249,33,5537718,5538509,718,5539227
815,56,56,5546142,5547057,932,5544527,5545323,813,5546136
816,6,6,5552818,5552901,100,5551353,5552137,675,5552812
817,20,20,5559827,5560143,333,5558162,5558951,870,5559821
818,26,26,5566453,5566869,433,5564971,5565765,681,5566446
819,22,22,5573495,5573845,367,5571781,5572579,911,5573490
820,46,46,5580338,5581087,766,5578607,5579393,939,5580332
821,4,4,5587047,5587097,67,5585416,5586207,834,5587041
822,38,38,5593624,5594240,632,5592225,5593021,596,5593617
823,24,24,5600366,5600749,400,5599051,5599835,525,5600360
824,12,12,5607392,5607575,200,5605860,5606649,736,5607385
825,38,38,5614001,5614617,633,5612670,5613463,532,5613995
826,34,34,5620961,5621510,566,5619479,5620277,677,5620954
827,12,12,5627637,5627820,200,5626305,5627091,539,5627630
828,34,34,5634762,5635312,566,5633114,5633905,851,5634756
829,56,56,5641572,5642487,932,5639923,5640719,846,5641565
830,10,10,5648214,5648364,167,5646749,5647533,675,5648208
831,38,38,5655223,5655839,633,5653559,5654347,871,5655218
832,54,54,5662016,5662898,899,5660368,5661161,849,5662010
833,6,6,5668642,5668725,100,5667177,5667975,661,5668636
834,2,2,5675318,5675335,34,5674003,5674789,523,5675312
835,4,4,5682211,5682261,66,5680812,5681603,601,5682204
836,2,2,5688954,5688970,33,5687622,5688417,530,5688947
837,40,40,5695796,5696445,666,5694448,5695231,559,5695790
838,38,38,5702988,5703604,633,5701257,5702045,937,5702982
839,36,36,5709848,5710430,599,5708066,5708859,982,5709841
840,58,58,5716291,5717240,965,5714875,5715673,611,5716284
841,8,8,5723350,5723466,133,5721701,5722487,856,5723343
842,28,28,5729876,5730325,466,5728511,5729301,569,5729870
843,2,2,5736985,5737001,33,5735320,5736115,864,5736979
844,6,6,5743594,5743678,100,5742146,5742929,659,5743588
845,26,26,5750570,5750986,433,5748955,5749743,821,5750564
846,6,6,5757096,5757180,100,5755764,5756557,532,5757089
847,28,28,5763906,5764355,466,5762574,5763371,528,5763899
848,52,52,5770765,5771614,866,5769400,5770185,574,5770759
849,14,14,5777774,5777990,233,5776209,5776999,769,5777768
850,44,44,5784633,5785349,733,5783018,5783813,814,5784627
851,36,36,5791259,5791842,600,5789844,5790627,626,5791253
852,2,2,5798368,5798385,34,5796653,5797441,921,5798362
853,14,14,5804778,5804994,233,5803463,5804255,517,5804772
854,60,60,5811654,5812636,999,5810272,5811069,578,5811647
855,6,6,5818713,5818796,100,5817098,5817883,824,5818707
856,6,6,5825422,5825506,100,5823907,5824697,719,5825416
857,20,20,5832232,5832548,333,5830717,5831511,715,5832226
858,18,18,5839174,5839457,300,5837543,5838325,843,5839168
859,52,52,5846117,5846966,865,5844352,5845139,972,5846111
860,20,20,5852593,5852909,333,5851161,5851953,633,5852586
861,20,20,5859336,5859652,333,5857970,5858767,562,5859329
862,34,34,5866195,5866744,566,5864796,5865581,607,5866188
863,22,22,5872954,5873304,366,5871606,5872395,553,5872948
864,22,22,5880080,5880429,366,5878415,5879209,865,5880074
865,6,6,5886706,5886789,100,5885224,5886023,676,5886699
866,20,20,5893449,5893765,333,5892050,5892837,605,5893442
867,14,14,5900591,5900807,233,5898859,5899651,933,5900584
868,4,4,5907084,5907134,66,5905669,5906465,613,5907078
869,26,26,5913810,5914226,433,5912495,5913279,525,5913804
870,38,38,5920702,5921318,633,5919304,5920093,603,5920696
871,54,54,5927645,5928527,899,5926113,5926907,731,5927638
872,14,14,5934604,5934820,233,5932922,5933721,876,5934597
873,48,48,5941530,5942312,799,5939748,5940535,988,5941523
874,44,44,5947956,5948672,733,5946558,5947349,601,5947950
875,32,32,5954982,5955498,533,5953367,5954163,813,5954976
876,32,32,5961558,5962074,533,5960193,5960977,575,5961552
877,28,28,5968584,5969033,466,5967002,5967791,786,5968577
878,48,48,5975593,5976375,799,5973811,5974605,981,5975586
879,44,44,5982286,5983001,732,5980621,5981419,861,5982280
880,18,18,5989145,5989428,300,5987447,5988233,906,5989139
881,2,2,5995937,5995954,34,5994256,5995047,884,5995931
882,44,44,6002480,6003196,733,6001065,6001861,613,6002474
883,50,50,6009623,6010438,832,6007891,6008675,941,6009616
884,8,8,6016016,6016132,133,6014700,6015489,520,6016009
885,28,28,6023141,6023591,467,6021510,6022303,832,6023135
886,4,4,6030084,6030134,66,6028319,6029117,961,6030078
887,50,50,6036727,6037542,832,6035145,6035931,789,6036720
888,42,42,6042570,6043253,700,6041954,6041962,601,6042563
889,40,40,6049579,6050229,666,6047981,6048776,797,6049573
890,44,44,6056522,6057238,732,6054807,6055590,926,6056516
891,44,44,6063381,6064097,733,6061616,6062404,971,6063375
892,28,28,6069874,6070324,466,6068426,6069218,650,6069868
893,32,32,6076650,6077166,533,6075235,6076032,612,6076644
894,14,14,6083393,6083609,233,6082061,6082846,540,6083386
895,58,58,6090518,6091467,966,6088870,6089660,852,6090512
896,6,6,6097178,6097261,100,6095679,6096474,697,6097171
897,24,24,6103937,6104320,400,6102505,6103288,642,6103930
898,6,6,6111029,6111113,100,6109315,6110102,922,6111024
899,44,44,6117689,6118405,732,6116124,6116916,767,6117683
900,36,36,6124615,6125197,599,6122933,6123730,878,6124608
901,28,28,6131208,6131657,466,6129759,6130544,657,6131201
902,20,20,6138333,6138649,333,6136568,6137358,969,6138327
903,58,58,6144843,6145792,965,6143378,6144172,665,6144837
904,46,46,6151968,6152718,766,6150204,6150986,977,6151963
905,8,8,6158744,6158861,134,6157013,6157800,938,6158738
906,20,20,6165171,6165487,333,6163822,6164614,550,6165164
907,4,4,6172030,6172080,67,6170631,6171428,595,6172023
908,22,22,6179156,6179505,366,6177457,6178242,907,6179149
909,14,14,6185682,6185898,233,6184267,6185056,620,6185676
910,38,38,6192691,6193307,633,6191076,6191870,815,6192685
911,30,30,6199267,6199750,500,6197885,6198684,576,6199260
912,24,24,6206443,6206826,399,6204711,6205498,938,6206436
913,36,36,6213002,6213585,600,6211520,6212312,683,6212995
914,4,4,6219995,6220045,66,6218330,6219126,863,6219989
915,48,48,6226521,6227303,799,6225156,6225940,575,6226515
916,26,26,6233463,6233880,433,6231965,6232754,703,6233457
917,56,56,6240406,6241321,932,6238774,6239568,831,6240399
918,24,24,6246949,6247332,399,6245584,6246382,561,6246943
919,44,44,6254158,6254873,732,6252409,6253196,955,6254151
920,28,28,6260750,6261200,467,6259219,6260010,734,6260744
921,8,8,6267377,6267493,133,6266028,6266824,546,6267370
922,8,8,6274386,6274502,133,6272854,6273638,741,6274379
923,4,4,6281345,6281395,66,6279663,6280452,886,6281338
924,16,16,6287888,6288137,266,6286473,6287266,616,6287882
925,38,38,6294730,6295346,633,6293282,6294080,644,6294724
926,8,8,6301523,6301639,133,6300108,6300894,623,6301517
927,24,24,6308649,6309031,399,6306917,6307708,934,6308642
928,12,12,6315042,6315225,199,6313726,6314522,513,6315035
929,30,30,6322067,6322550,500,6320552,6321336,725,6322061
930,32,32,6328743,6329260,533,6327362,6328150,587,6328737
931,20,20,6335686,6336002,333,6334171,6334964,716,6335680
932,36,36,6342329,6342911,599,6340980,6341778,544,6342322
933,22,22,6349271,6349621,366,6347806,6348592,673,6349265
934,32,32,6356380,6356896,533,6354615,6355406,968,6356374
935,44,44,6362806,6363522,733,6361425,6362220,580,6362800
936,52,52,6369799,6370648,866,6368251,6369034,759,6369793
937,4,4,6376375,6376425,67,6375060,6375848,521,6376369
938,18,18,6383168,6383451,299,6381869,6382662,499,6383161
939,12,12,6390410,6390593,200,6388678,6389476,927,6390403
940,24,24,6396870,6397252,399,6395504,6396290,573,6396863
941,18,18,6403646,6403929,299,6402314,6403104,535,6403639
942,22,22,6410422,6410771,366,6409123,6409918,497,6410415
943,38,38,6417314,6417930,633,6415949,6416732,576,6417308
944,56,56,6424190,6425106,932,6422758,6423546,637,6424183
945,12,12,6431232,6431415,200,6429567,6430360,866,6431226
946,38,38,6437775,6438391,633,6436377,6437174,595,6437769
947,12,12,6444934,6445117,200,6443203,6443988,940,6444928
948,48,48,6451544,6452326,799,6450012,6450802,735,6451537
949,14,14,6458386,6458603,233,6456821,6457616,764,6458380
950,54,54,6465329,6466211,899,6463647,6464430,892,6465322
951,60,60,6472138,6473120,999,6470456,6471244,887,6472131
952,48,48,6478881,6479663,799,6477266,6478058,817,6478875
953,58,58,6485424,6486373,965,6484075,6484872,545,6485417
954,50,50,6492599,6493415,833,6490901,6491686,907,6492593
955,54,54,6499309,6500191,899,6497710,6498500,802,6499302
956,24,24,6505918,6506301,400,6504520,6505314,598,6505912
957,52,52,6512977,6513826,866,6511345,6512128,842,6512970
958,6,6,6519886,6519969,100,6518155,6518942,938,6519880
959,46,46,6526379,6527128,766,6524964,6525756,617,6526373
960,18,18,6533372,6533655,299,6531773,6532570,795,6533365
961,38,38,6539981,6540597,633,6538599,6539384,590,6539974
962,22,22,6547157,6547506,366,6545409,6546198,953,6547151
963,16,16,6553666,6553916,267,6552218,6553012,648,6553660
964,10,10,6560659,6560809,166,6559027,6559826,826,6560652
965,56,56,6567168,6568084,933,6565853,6566640,522,6567162
966,42,42,6574410,6575093,700,6572662,6573454,950,6574404
967,28,28,6581020,6581469,466,6579472,6580268,746,6581014
968,48,48,6587946,6588728,799,6586298,6587082,858,6587940
969,6,6,6594539,6594622,100,6593107,6593896,636,6594532
970,30,30,6601614,6602097,500,6599916,6600710,898,6601608
971,38,38,6608057,6608673,633,6606725,6607524,526,6608050
972,6,6,6615266,6615349,100,6613551,6614338,922,6615260
973,52,52,6622142,6622991,866,6620361,6621152,984,6622136
974,14,14,6628585,6628801,233,6627170,6627966,613,6628579
975,56,56,6635311,6636227,932,6633996,6634780,525,6635305
976,38,38,6642270,6642886,633,6640805,6641594,670,6642264
977,56,56,6649063,6649979,932,6647614,6648408,648,6649056
978,8,8,6656122,6656238,133,6654424,6655222,894,6656116
979,22,22,6662865,6663214,366,6661250,6662036,823,6662859
980,36,36,6669740,6670323,600,6668059,6668850,884,6669734
981,26,26,6676200,6676616,433,6674868,6675664,529,6676193
982,58,58,6683076,6684025,966,6681694,6682478,591,6683069
983,18,18,6690135,6690418,300,6688503,6689292,836,6690128
984,30,30,6696944,6697427,500,6695313,6696106,832,6696938
985,54,54,6703737,6704619,899,6702122,6702920,811,6703731
986,18,18,6710613,6710896,299,6708948,6709734,873,6710607
987,34,34,6717472,6718021,566,6715757,6716548,918,6717466
