TRL_NUMBER,TRL_STOP_SIGNAL_DELAY,TRL_TARG_SSD_VRT_RFRSH_COUNT,TRL_TARG_ON_TIME,TRL_STOP_SIGNAL_TIME,TRL_STOP_SIGNAL_DURATION,TRL_FIX_ON_TIME,TRL_FIX_ACQ_TIME,TRL_FIX_HOLD_TIME,TRL_FIXATED_TIME
1,4,4,2391,2441,66,1075,1859,526,2385
2,54,54,9400,10282,899,7885,8673,720,9393
3,2,2,16159,16176,33,14694,15487,659,16146
4,56,56,23018,23934,933,21503,22301,707,23008
5,44,44,29894,30610,733,28329,29115,777,29892
6,38,38,36637,37253,633,35139,35929,693,36622
7,22,22,43746,44096,366,41948,42743,999,43742
8,46,46,50439,51188,766,48774,49557,872,50429
9,18,18,57032,57315,299,55583,56371,658,57029
10,60,60,63824,64806,999,62392,63185,622,63807
11,12,12,70683,70867,200,69202,69999,676,70675
12,32,32,77676,78192,533,76028,76813,855,77668
13,50,50,84402,85218,832,82837,83627,762,84389
14,24,24,90961,91344,400,89646,90441,508,90949
15,48,48,97854,98636,799,96472,97255,596,97851
16,56,56,104863,105779,932,103281,104069,776,104845
17,46,46,111739,112488,766,110091,110883,849,111732
18,48,48,118648,119431,799,116900,117697,936,118633
19,4,4,125174,125224,67,123726,124511,654,125165
20,22,22,132217,132566,366,130535,131325,887,132212
21,46,46,139142,139892,766,137344,138139,999,139138
22,50,50,145719,146534,832,144170,144953,748,145701
23,6,6,152611,152694,100,150980,151767,833,152600
24,42,42,159137,159820,700,157789,158581,550,159131
25,12,12,166047,166230,199,164598,165395,644,166039
26,24,24,172972,173355,400,171424,172209,759,172968
27,32,32,179565,180081,533,178233,179023,533,179556
28,40,40,186608,187257,666,185043,185837,762,186599
29,8,8,193384,193500,133,191852,192651,724,193375
30,12,12,200343,200526,200,198678,199465,860,200325
31,6,6,206919,207002,100,205487,206279,634,206913
32,38,38,213678,214294,633,212297,213093,583,213676
33,18,18,220887,221170,300,219122,219907,966,220873
34,20,20,227413,227730,333,225932,226721,687,227408
35,38,38,234423,235039,632,232741,233535,874,234409
36,28,28,240965,241415,467,239550,240349,601,240950
37,46,46,248008,248757,766,246376,247163,838,248001
38,16,16,254817,255067,267,253186,253977,829,254806
39,42,42,261527,262209,699,259995,260791,727,261518
40,6,6,268169,268253,100,266821,267605,553,268158
41,44,44,275029,275744,732,273630,274419,596,275015
42,12,12,281954,282137,200,280439,281233,705,281938
43,26,26,288730,289147,433,287249,288047,671,288718
44,34,34,295506,296056,566,294075,294861,637,295498
45,22,22,302632,302982,366,300884,301675,941,302616
46,56,56,309125,310041,932,307693,308489,619,309108
47,48,48,316184,316966,799,314519,315303,870,316173
48,54,54,322860,323742,899,321328,322117,733,322850
49,30,30,329802,330285,500,328138,328931,866,329797
50,40,40,336695,337344,666,334947,335745,938,336683
51,24,24,343421,343804,400,341773,342559,856,343415
52,20,20,350364,350680,333,348582,349373,973,350346
53,44,44,356973,357689,733,355391,356187,778,356965
54,14,14,363599,363816,233,362217,363001,595,363596
55,42,42,370492,371174,699,369027,369815,669,370484
56,30,30,377634,378117,499,375836,376629,999,377628
57,14,14,384127,384343,233,382645,383443,675,384118
58,24,24,391103,391486,399,389471,390257,828,391085
59,16,16,397646,397895,266,396280,397071,564,397635
60,50,50,404438,405254,833,403090,403885,548,404433
61,60,60,411381,412363,999,409916,410699,674,411373
62,58,58,418257,419206,965,416725,417513,740,418253
63,6,6,424866,424949,100,423534,424327,536,424863
64,38,38,431792,432408,633,430344,431141,636,431777
65,30,30,438734,439217,500,437169,437955,773,438728
66,42,42,445277,445960,700,443979,444769,506,445275
67,44,44,452586,453302,733,450788,451583,993,452576
68,60,60,459146,460128,999,457614,458397,731,459128
69,50,50,465938,466754,833,464423,465211,722,465933
70,20,20,472997,473314,333,471233,472025,962,472987
71,40,40,479773,480423,666,478042,478839,918,479757
72,60,60,486533,487515,999,484868,485653,864,486517
73,30,30,493325,493808,500,491677,492467,854,493321
74,50,50,499918,500734,833,498486,499281,621,499902
75,42,42,506694,507377,699,505312,506095,590,506685
76,14,14,513736,513953,234,512122,512909,824,513733
77,54,54,520696,521578,899,518931,519723,954,520677
78,60,60,527172,528154,999,525740,526537,631,527168
79,48,48,533981,534764,799,532566,533351,618,533969
80,30,30,540707,541190,500,539375,540165,536,540701
81,56,56,547650,548565,932,546185,546979,659,547638
82,24,24,554526,554908,399,553011,553793,718,554511
83,32,32,561335,561851,533,559820,560607,724,561331
84,6,6,568261,568344,100,566629,567421,828,568249
85,18,18,575236,575519,300,573438,574235,986,575221
86,30,30,581613,582096,499,580264,581049,552,581601
87,48,48,588455,589238,800,587074,587863,579,588442
88,38,38,595681,596297,633,593883,594677,999,595676
89,46,46,602374,603123,766,600692,601491,878,602369
90,46,46,609250,609999,765,607518,608305,940,609245
91,2,2,615826,615842,33,614327,615119,689,615808
92,52,52,622802,623651,865,621137,621933,856,622789
93,32,32,629628,630144,532,627963,628747,866,629613
94,44,44,636087,636803,733,634772,635561,515,636076
95,60,60,643146,644128,999,641581,642375,769,643144
96,36,36,649323,649906,599,648390,648406,905,649311
97,58,58,655799,656748,966,654434,655220,567,655787
98,38,38,662758,663374,633,661243,662034,719,662753
99,36,36,669684,670267,599,668053,668848,828,669676
100,54,54,676577,677459,899,674878,675662,901,676563
101,30,30,683120,683602,499,681688,682476,626,683102
102,18,18,689979,690262,299,688497,689290,678,689968
103,26,26,696838,697254,433,695306,696104,726,696830
104,4,4,703514,703564,67,702132,702918,581,703499
105,14,14,710490,710706,233,708942,709732,749,710481
106,6,6,717233,717316,99,715751,716546,670,717216
107,6,6,724142,724225,100,722577,723360,778,724138
108,34,34,731134,731684,566,729386,730174,951,731125
109,22,22,737977,738326,366,736195,736988,979,737967
110,32,32,744586,745102,533,743005,743802,776,744578
111,14,14,751396,751612,233,749831,750616,764,751380
112,50,50,758305,759120,832,756640,757430,859,758289
113,6,6,764748,764831,100,763449,764244,501,764745
114,32,32,771790,772306,533,770275,771058,729,771787
115,42,42,778549,779232,700,777084,777872,659,778531
116,34,34,785575,786125,566,783894,784686,872,785558
117,16,16,792418,792667,266,790703,791500,907,792407
118,14,14,798994,799210,233,797529,798314,668,798982
119,6,6,805787,805870,99,804338,805128,643,805771
120,56,56,812846,813761,932,811147,811942,890,812832
121,18,18,819738,820021,300,817973,818756,975,819731
122,50,50,826531,827347,832,824783,825570,946,826516
123,16,16,833307,833556,266,831592,832384,920,833304
124,14,14,839167,839383,233,838401,838415,741,839156
125,4,4,845826,845876,67,844445,845229,592,845821
126,52,52,852736,853585,865,851254,852043,685,852728
127,10,10,859628,859778,167,858063,858857,765,859622
128,42,42,866621,867303,699,864873,865671,941,866612
129,58,58,873380,874329,966,871698,872485,878,873363
130,20,20,879890,880206,333,878508,879299,581,879880
131,18,18,886815,887098,300,885317,886113,697,886810
132,34,34,893508,894058,566,892143,892927,579,893506
133,32,32,900584,901100,533,898952,899741,837,900578
134,12,12,907210,907393,200,905762,906555,647,907202
135,54,54,914152,915035,899,912571,913369,765,914134
136,4,4,921128,921178,67,919397,920183,937,921120
137,52,52,927754,928603,866,926206,926997,744,927741
138,26,26,934447,934863,433,933015,933811,629,934440
139,58,58,941290,942239,965,939841,940625,647,941272
140,22,22,948249,948598,366,946651,947439,793,948232
141,4,4,955225,955275,66,953460,954253,961,955214
142,42,42,961951,962633,699,960269,961067,879,961946
143,58,58,968643,969592,966,967095,967881,751,968632
144,16,16,975220,975469,266,973904,974695,509,975204
145,36,36,982129,982711,599,980714,981509,606,982115
146,34,34,989238,989787,566,987540,988323,907,989230
147,16,16,995747,995997,267,994349,995137,605,995742
148,20,20,1002756,1003073,333,1001158,1001951,803,1002754
149,26,26,1009582,1009999,433,1007967,1008765,812,1009577
150,44,44,1016508,1017224,733,1014793,1015579,925,1016504
151,32,32,1023251,1023767,533,1021603,1022393,850,1023243
152,34,34,1029777,1030326,566,1028412,1029207,554,1029761
153,22,22,1036819,1037169,367,1035238,1036021,796,1036817
154,22,22,1043679,1044028,366,1042047,1042835,832,1043667
155,34,34,1050538,1051087,566,1048856,1049649,876,1050525
156,4,4,1057097,1057147,67,1055666,1056463,629,1057092
157,42,42,1064256,1064939,700,1062492,1063277,970,1064247
158,30,30,1070666,1071149,500,1069301,1070091,560,1070651
159,12,12,1077542,1077725,200,1076110,1076905,626,1077531
160,58,58,1084501,1085450,966,1082936,1083719,770,1084489
161,26,26,1091127,1091543,433,1089745,1090533,589,1091122
162,4,4,1097887,1097937,66,1096555,1097347,523,1097870
163,8,8,1104679,1104796,133,1103364,1104161,507,1104668
164,8,8,1111855,1111971,133,1110190,1110975,862,1111837
165,10,10,1118581,1118731,166,1116999,1117789,780,1118569
166,42,42,1125407,1126089,699,1123809,1124603,794,1125397
167,14,14,1131950,1132166,233,1130634,1131417,527,1131944
168,60,60,1139092,1140074,999,1137444,1138231,843,1139074
169,16,16,1145751,1146001,267,1144253,1145045,693,1145738
170,18,18,1152627,1152910,300,1151062,1151859,760,1152619
171,12,12,1159387,1159570,199,1157888,1158673,710,1159383
172,34,34,1166429,1166978,566,1164698,1165487,924,1166411
173,48,48,1173072,1173854,799,1171507,1172301,759,1173060
174,26,26,1179748,1180164,433,1178316,1179115,620,1179735
175,2,2,1186840,1186857,33,1185142,1185929,905,1186834
176,50,50,1193600,1194415,832,1191951,1192743,845,1193588
177,18,18,1200376,1200659,299,1198761,1199557,807,1200364
178,20,20,1207368,1207684,333,1205587,1206371,992,1207363
179,58,58,1213994,1214943,966,1212396,1213185,806,1213991
180,12,12,1220986,1221170,200,1219205,1219999,985,1220984
181,12,12,1227779,1227962,200,1226014,1226813,956,1227769
182,34,34,1234222,1234772,566,1232840,1233627,585,1234212
183,4,4,1241031,1241081,67,1239650,1240441,585,1241026
184,10,10,1247874,1248024,167,1246459,1247255,611,1247866
185,28,28,1255000,1255449,466,1253285,1254069,919,1254988
186,4,4,1261642,1261692,67,1260094,1260883,748,1261631
187,4,4,1268319,1268368,66,1266903,1267697,615,1268312
188,40,40,1275361,1276010,666,1273713,1274511,847,1275358
189,6,6,1281904,1281987,100,1280539,1281325,564,1281889
190,12,12,1289029,1289213,200,1287348,1288139,884,1289023
191,56,56,1295922,1296838,932,1294157,1294953,961,1295914
192,28,28,1302748,1303197,466,1300983,1301767,967,1302734
193,30,30,1309457,1309940,500,1307792,1308581,869,1309450
194,54,54,1316000,1316883,899,1314602,1315395,593,1315988
195,18,18,1322959,1323242,300,1321411,1322209,748,1322957
196,6,6,1329885,1329968,100,1328237,1329023,857,1329880
197,4,4,1336528,1336578,67,1335046,1335837,680,1336517
198,38,38,1343287,1343903,633,1341855,1342651,628,1343279
199,10,10,1350047,1350196,166,1348681,1349465,576,1350041
200,6,6,1357139,1357222,100,1355491,1356279,850,1357129
201,2,2,1363932,1363948,33,1362300,1363093,832,1363925
202,52,52,1370824,1371673,866,1369109,1369907,907,1370814
203,56,56,1377434,1378349,932,1375935,1376721,710,1377431
204,56,56,1384160,1385075,932,1382744,1383535,607,1384142
205,26,26,1391002,1391418,433,1389554,1390349,641,1390990
206,54,54,1398111,1398994,899,1396380,1397163,939,1398102
207,16,16,1404621,1404871,266,1403189,1403977,627,1404604
208,32,32,1411430,1411946,533,1409998,1410791,633,1411424
209,36,36,1418556,1419138,599,1416808,1417605,933,1418538
210,42,42,1425115,1425798,699,1423634,1424419,690,1425109
211,2,2,1432024,1432041,34,1430443,1431233,786,1432019
212,26,26,1438617,1439033,433,1437252,1438047,558,1438605
213,56,56,1445859,1446775,933,1444078,1444861,995,1445856
214,30,30,1452386,1452868,499,1450887,1451675,694,1452369
215,22,22,1459128,1459478,367,1457697,1458489,631,1459120
216,22,22,1466287,1466637,367,1464506,1465303,979,1466282
217,34,34,1472947,1473496,566,1471332,1472117,825,1472942
218,4,4,1479556,1479606,67,1478141,1478931,609,1479540
219,20,20,1486632,1486948,333,1484950,1485745,883,1486628
220,22,22,1493541,1493891,366,1491776,1492559,976,1493535
221,24,24,1500084,1500467,400,1498586,1499373,699,1500072
222,28,28,1507110,1507559,466,1505395,1506187,919,1507106
223,14,14,1513952,1514169,233,1512204,1513001,947,1513948
224,40,40,1520379,1521028,666,1519030,1519815,559,1520374
225,50,50,1527454,1528270,833,1525839,1526629,810,1527439
226,54,54,1534397,1535279,899,1532649,1533443,941,1534384
227,8,8,1541040,1541156,133,1539475,1540257,772,1541029
228,46,46,1547965,1548715,766,1546284,1547071,891,1547962
229,50,50,1554841,1555657,833,1553093,1553885,952,1554837
230,34,34,1561368,1561917,566,1559902,1560699,658,1561357
231,44,44,1568110,1568826,733,1566728,1567513,584,1568097
232,24,24,1575219,1575602,400,1573538,1574327,887,1575214
233,14,14,1581646,1581862,233,1580347,1581141,501,1581642
234,48,48,1588638,1589420,799,1587156,1587955,668,1588623
235,12,12,1595397,1595580,200,1593982,1594769,623,1595392
236,32,32,1602523,1603039,533,1600791,1601583,929,1602512
237,18,18,1609332,1609615,300,1607601,1608397,930,1609327
238,56,56,1616108,1617024,933,1614427,1615211,889,1616100
239,8,8,1622102,1622218,133,1621236,1621242,856,1622098
240,34,34,1628595,1629144,566,1627263,1628056,535,1628591
241,28,28,1635704,1636153,466,1634072,1634870,831,1635701
242,44,44,1642613,1643329,732,1640898,1641684,922,1642606
243,14,14,1649222,1649439,233,1647707,1648498,719,1649217
244,32,32,1655865,1656381,533,1654517,1655312,543,1655855
245,52,52,1663124,1663973,866,1661343,1662126,990,1663116
246,44,44,1669833,1670549,733,1668152,1668940,877,1669817
247,38,38,1676693,1677309,632,1674961,1675754,922,1676676
248,28,28,1683136,1683585,466,1681770,1682568,552,1683120
249,60,60,1689978,1690960,999,1688596,1689382,590,1689972
250,24,24,1696804,1697187,400,1695406,1696196,598,1696794
251,52,52,1703780,1704629,866,1702215,1703010,760,1703770
252,10,10,1710639,1710789,167,1709041,1709824,810,1710634
253,40,40,1717598,1718247,666,1715850,1716638,951,1717589
254,22,22,1724258,1724607,366,1722659,1723452,790,1724242
255,46,46,1731067,1731816,766,1729469,1730266,788,1731054
256,30,30,1737843,1738326,499,1736295,1737080,755,1737835
257,52,52,1744902,1745751,866,1743104,1743894,998,1744892
258,12,12,1751295,1751478,200,1749913,1750708,581,1751289
259,26,26,1758254,1758670,433,1756739,1757522,715,1758237
260,58,58,1765047,1765996,965,1763548,1764336,701,1765037
261,52,52,1771906,1772755,866,1770358,1771150,752,1771902
262,28,28,1778799,1779248,466,1777167,1777964,818,1778782
263,58,58,1785558,1786507,966,1783993,1784778,769,1785547
264,60,60,1792500,1793483,999,1790802,1791592,906,1792498
265,30,30,1799243,1799726,500,1797611,1798406,821,1799227
266,58,58,1806002,1806951,966,1804437,1805220,775,1805995
267,44,44,1812712,1813428,732,1811247,1812034,675,1812709
268,50,50,1819654,1820470,833,1818056,1818848,791,1819639
269,52,52,1826464,1827313,865,1824865,1825662,799,1826461
270,30,30,1833190,1833672,499,1831691,1832476,699,1833175
271,20,20,1840199,1840515,333,1838500,1839290,896,1840186
272,48,48,1846858,1847641,799,1845310,1846104,738,1846842
273,36,36,1853900,1854483,600,1852119,1852918,971,1853889
274,10,10,1860294,1860443,166,1858945,1859732,556,1860288
275,4,4,1867353,1867402,66,1865754,1866546,791,1867337
276,48,48,1874212,1874994,799,1872564,1873360,837,1874197
277,18,18,1880938,1881221,300,1879389,1880174,748,1880922
278,30,30,1887497,1887980,500,1886199,1886988,503,1887491
279,52,52,1894357,1895206,865,1893008,1893802,536,1894338
280,14,14,1901282,1901499,234,1899817,1900616,648,1901264
281,28,28,1908341,1908791,467,1906643,1907430,893,1908323
282,50,50,1915184,1916000,832,1913453,1914244,926,1915170
283,32,32,1921610,1922126,533,1920262,1921058,548,1921606
284,16,16,1928486,1928736,267,1927088,1927872,600,1928472
285,38,38,1935629,1936245,632,1933897,1934686,925,1935611
286,54,54,1942321,1943204,899,1940706,1941500,812,1942312
287,38,38,1949047,1949663,633,1947516,1948314,723,1949037
288,48,48,1956123,1956905,799,1954342,1955128,989,1956117
289,56,56,1962516,1963432,932,1961151,1961942,559,1962501
290,50,50,1969359,1970174,832,1967960,1968756,588,1969344
291,4,4,1976384,1976434,67,1974786,1975570,806,1976376
292,16,16,1983177,1983427,266,1981595,1982384,784,1983168
293,18,18,1989970,1990253,299,1988405,1989198,768,1989966
294,60,60,1996912,1997894,999,1995214,1996012,885,1996897
295,14,14,2003821,2004038,233,2002040,2002826,984,2003810
296,14,14,2010497,2010714,233,2008849,2009640,842,2010482
297,6,6,2017390,2017473,100,2015658,2016454,921,2017375
298,10,10,2024232,2024382,167,2022484,2023268,951,2024219
299,10,10,2030859,2031008,166,2029294,2030082,769,2030851
300,48,48,2037751,2038534,799,2036103,2036896,853,2037749
301,42,42,2044311,2044993,699,2042912,2043710,591,2044301
302,22,22,2051120,2051470,366,2049738,2050524,594,2051118
303,52,52,2058229,2059078,866,2056547,2057338,887,2058225
304,50,50,2064938,2065754,833,2063357,2064152,778,2064930
305,54,54,2071498,2072380,899,2070183,2070966,514,2071480
306,34,34,2078341,2078890,566,2076992,2077780,542,2078322
307,22,22,2085599,2085949,367,2083801,2084594,989,2085583
308,16,16,2091992,2092242,267,2090611,2091408,577,2091985
309,20,20,2098785,2099101,333,2097436,2098222,558,2098780
310,56,56,2105994,2106910,932,2104246,2105036,954,2105990
311,8,8,2112437,2112553,133,2111055,2111850,571,2112421
312,24,24,2119363,2119746,399,2117881,2118664,686,2119350
313,8,8,2126072,2126189,133,2124690,2125478,587,2126065
314,40,40,2133098,2133747,666,2131500,2132292,788,2133080
315,2,2,2139841,2139857,33,2138309,2139106,719,2139825
316,30,30,2146850,2147332,499,2145135,2145920,925,2146845
317,18,18,2153359,2153642,300,2151944,2152734,620,2153354
318,54,54,2160385,2161267,899,2158753,2159548,834,2160382
319,50,50,2166878,2167694,832,2165579,2166362,504,2166866
320,10,10,2174020,2174170,167,2172389,2173176,842,2174018
321,20,20,2180646,2180963,333,2179198,2179990,647,2180637
322,32,32,2187622,2188138,533,2186007,2186804,805,2187609
323,14,14,2194182,2194398,233,2192833,2193618,548,2194166
324,54,54,2201191,2202073,899,2199642,2200432,748,2201180
325,24,24,2207983,2208366,400,2206452,2207246,732,2207978
326,44,44,2214976,2215692,732,2213278,2214060,911,2214971
327,54,54,2221685,2222568,899,2220087,2220874,808,2221682
328,50,50,2228494,2229310,833,2226896,2227688,790,2228478
329,30,30,2235503,2235986,500,2233705,2234502,984,2235486
330,52,52,2242030,2242879,865,2240531,2241316,705,2242021
331,44,44,2248656,2249372,732,2247341,2248130,510,2248640
332,10,10,2255482,2255632,166,2254150,2254944,523,2255467
333,8,8,2262607,2262724,134,2260959,2261758,837,2262595
334,24,24,2269084,2269467,399,2267785,2268572,501,2269073
335,50,50,2276060,2276875,832,2274594,2275386,667,2276053
336,12,12,2283119,2283302,199,2281404,2282200,906,2283106
337,44,44,2289878,2290594,732,2288230,2289014,857,2289871
338,42,42,2296704,2297386,699,2295039,2295828,866,2296694
339,12,12,2303347,2303530,199,2301848,2302642,696,2303338
340,12,12,2310389,2310572,200,2308658,2309456,920,2310376
341,52,52,2317032,2317881,866,2315483,2316270,753,2317023
342,50,50,2323908,2324723,832,2322293,2323084,808,2323892
343,2,2,2330434,2330451,33,2329102,2329898,528,2330426
344,2,2,2337543,2337560,33,2335928,2336712,815,2337527
345,4,4,2344469,2344519,66,2342737,2343526,925,2344451
346,18,18,2351112,2351395,299,2349547,2350340,757,2351097
347,42,42,2357887,2358570,700,2356356,2357154,716,2357870
348,38,38,2364947,2365563,632,2363182,2363968,976,2364944
349,34,34,2371772,2372322,567,2369991,2370782,988,2371770
350,52,52,2378199,2379048,866,2376800,2377596,587,2378183
351,26,26,2384942,2385358,432,2383626,2384410,523,2384933
352,10,10,2391751,2391901,166,2390436,2391224,516,2391740
353,16,16,2398860,2399109,266,2397245,2398038,816,2398854
354,22,22,2405586,2405935,366,2404054,2404852,721,2405573
355,48,48,2412212,2412994,799,2410880,2411666,542,2412208
356,26,26,2419021,2419437,433,2417689,2418480,539,2419019
357,42,42,2426030,2426713,700,2424499,2425294,726,2426020
358,52,52,2432790,2433639,865,2431325,2432108,671,2432779
359,32,32,2439632,2440148,533,2438134,2438922,692,2439614
360,46,46,2446425,2447174,766,2444943,2445736,677,2446413
361,18,18,2453251,2453534,299,2451752,2452550,687,2453237
362,46,46,2459960,2460709,766,2458578,2459364,589,2459953
363,32,32,2466936,2467452,533,2465388,2466178,749,2466927
364,26,26,2473878,2474295,433,2472197,2472992,878,2473870
365,10,10,2480704,2480854,167,2479023,2479806,882,2480688
366,36,36,2487347,2487930,600,2485832,2486620,722,2487342
367,42,42,2494240,2494922,699,2492641,2493434,795,2494229
368,42,42,2500849,2501532,699,2499451,2500248,585,2500833
369,18,18,2507858,2508141,300,2506277,2507062,787,2507849
370,12,12,2514634,2514817,200,2513086,2513876,744,2514620
371,56,56,2521360,2522276,933,2519895,2520690,668,2521358
372,44,44,2528053,2528769,733,2526721,2527504,536,2528040
373,52,52,2534912,2535761,866,2533530,2534318,592,2534910
374,30,30,2541988,2542471,499,2540340,2541132,838,2541970
375,6,6,2548547,2548631,100,2547149,2547946,592,2548538
376,56,56,2555623,2556539,932,2553975,2554760,855,2555615
377,4,4,2562233,2562283,66,2560784,2561574,651,2562225
378,52,52,2569242,2570091,865,2567594,2568388,845,2569233
379,40,40,2575785,2576434,666,2574419,2575202,573,2575775
380,50,50,2582960,2583776,833,2581229,2582016,939,2582955
381,26,26,2589736,2590152,433,2588038,2588830,890,2589720
382,38,38,2596262,2596878,633,2594847,2595644,601,2596245
383,12,12,2602972,2603155,200,2601673,2602458,506,2602964
384,26,26,2609814,2610231,433,2608483,2609272,530,2609802
385,18,18,2616657,2616940,300,2615292,2616086,557,2616643
386,14,14,2623733,2623949,233,2622101,2622900,829,2623729
387,50,50,2630542,2631358,832,2628927,2629714,824,2630538
388,24,24,2637052,2637434,399,2635736,2636528,505,2637033
389,48,48,2644344,2645126,799,2642546,2643342,986,2644328
390,56,56,2650787,2651702,932,2649372,2650156,620,2650776
391,46,46,2657579,2658328,766,2656181,2656970,607,2657577
392,36,36,2664638,2665221,600,2662990,2663784,845,2664629
393,36,36,2671481,2672064,599,2669799,2670598,872,2671470
394,10,10,2678007,2678157,167,2676625,2677412,577,2677989
395,46,46,2684983,2685732,766,2683435,2684226,753,2684979
396,12,12,2691642,2691826,200,2690244,2691040,584,2691624
397,52,52,2698535,2699384,866,2697070,2697854,676,2698530
398,20,20,2705577,2705894,333,2703879,2704668,903,2705571
399,44,44,2712153,2712869,733,2710688,2711482,666,2712148
400,26,26,2718846,2719262,433,2717498,2718296,546,2718842
401,32,32,2725939,2726455,532,2724324,2725110,811,2725921
402,48,48,2732848,2733630,799,2731133,2731924,909,2732833
403,14,14,2739640,2739857,233,2737942,2738738,890,2739628
404,34,34,2746416,2746966,566,2744768,2745552,859,2746411
405,22,22,2753342,2753692,366,2751577,2752366,967,2753333
406,54,54,2760151,2761034,900,2758387,2759180,959,2760139
407,56,56,2766911,2767826,932,2765196,2765994,908,2766902
408,50,50,2773337,2774153,833,2772022,2772808,518,2773326
409,44,44,2780563,2781279,732,2778831,2779622,930,2780552
410,34,34,2787039,2787588,566,2785640,2786436,599,2787035
411,40,40,2794015,2794664,666,2792466,2793250,753,2794003
412,30,30,2800641,2801124,499,2799276,2800064,566,2800630
413,12,12,2807384,2807567,199,2806085,2806878,501,2807379
414,40,40,2814509,2815158,666,2812894,2813692,802,2814494
415,34,34,2821452,2822001,566,2819720,2820506,943,2821449
416,10,10,2828128,2828278,166,2826530,2827320,797,2828117
417,18,18,2834787,2835070,300,2833339,2834134,637,2834771
418,6,6,2841696,2841780,100,2840165,2840948,742,2841690
419,36,36,2848589,2849172,599,2846974,2847762,815,2848577
420,56,56,2855198,2856114,933,2853783,2854576,606,2855182
421,4,4,2862257,2862307,67,2860593,2861390,860,2862250
422,38,38,2868983,2869599,633,2867419,2868204,766,2868970
423,24,24,2875593,2875976,400,2874228,2875018,562,2875580
424,46,46,2882519,2883268,766,2881037,2881832,674,2882506
425,2,2,2889528,2889545,33,2887863,2888646,868,2889514
426,38,38,2896254,2896870,633,2894672,2895460,788,2896248
427,36,36,2902281,2902863,599,2901482,2901491,772,2902263
428,22,22,2908990,2909340,366,2907508,2908305,670,2908975
429,26,26,2915816,2916232,433,2914334,2915119,686,2915805
430,14,14,2922725,2922942,233,2921144,2921933,785,2922718
431,44,44,2929568,2930284,732,2927953,2928747,809,2929556
432,20,20,2936527,2936843,333,2934762,2935561,963,2936524
433,42,42,2943136,2943819,700,2941588,2942375,754,2943129
434,14,14,2949962,2950179,233,2948397,2949189,770,2949959
435,2,2,2956988,2957005,33,2955207,2956003,969,2956972
436,28,28,2963398,2963847,466,2962033,2962817,575,2963392
437,30,30,2970457,2970940,499,2968842,2969631,810,2970441
438,38,38,2977383,2977999,632,2975651,2976445,930,2977375
439,52,52,2983842,2984691,866,2982460,2983259,570,2983829
440,38,38,2990585,2991201,633,2989286,2990073,502,2990575
441,6,6,2997727,2997811,100,2996096,2996887,837,2997724
442,2,2,3004353,3004370,34,3002905,3003701,640,3004341
443,16,16,3011263,3011512,266,3009731,3010515,734,3011249
444,12,12,3017922,3018105,200,3016540,3017329,589,3017918
445,28,28,3025098,3025547,466,3023350,3024143,940,3025083
446,44,44,3031557,3032273,733,3030159,3030957,593,3031550
447,8,8,3038383,3038500,133,3036985,3037771,595,3038366
448,38,38,3045542,3046158,633,3043794,3044585,954,3045539
449,24,24,3052102,3052485,399,3050603,3051399,691,3052090
450,58,58,3059127,3060076,966,3057429,3058213,912,3059125
451,58,58,3065837,3066786,965,3064239,3065027,801,3065828
452,20,20,3072446,3072763,333,3071048,3071841,598,3072439
453,16,16,3079339,3079589,266,3077857,3078655,676,3079331
454,50,50,3086231,3087047,833,3084683,3085469,749,3086218
455,4,4,3093024,3093074,67,3091492,3092283,732,3093015
456,52,52,3099683,3100533,866,3098302,3099097,584,3099681
457,22,22,3106426,3106776,366,3105128,3105911,503,3106414
458,38,38,3113635,3114251,633,3111937,3112725,894,3113619
459,54,54,3120328,3121210,899,3118746,3119539,777,3120316
460,58,58,3127337,3128286,965,3125555,3126353,973,3127326
461,28,28,3133730,3134179,466,3132381,3133167,550,3133717
462,20,20,3140939,3141255,333,3139191,3139981,945,3140926
463,28,28,3147665,3148114,466,3146000,3146795,853,3147648
464,6,6,3154174,3154258,100,3152826,3153609,547,3154156
465,38,38,3161167,3161783,632,3159635,3160423,733,3161156
466,24,24,3167926,3168309,400,3166444,3167237,686,3167923
467,46,46,3174586,3175335,765,3173254,3174051,526,3174577
468,26,26,3181761,3182177,433,3180080,3180865,894,3181759
469,52,52,3188371,3189220,865,3186889,3187679,685,3188364
470,2,2,3195013,3195030,34,3193698,3194493,513,3195006
471,48,48,3201923,3202705,799,3200524,3201307,597,3201904
472,50,50,3208798,3209614,833,3207333,3208121,669,3208790
473,16,16,3215808,3216057,266,3214143,3214935,864,3215799
474,50,50,3222534,3223349,832,3220952,3221749,778,3222527
475,10,10,3229559,3229709,167,3227778,3228563,990,3229553
476,26,26,3236102,3236518,433,3234587,3235377,713,3236090
477,52,52,3242712,3243561,865,3241396,3242191,511,3242702
478,34,34,3248822,3249371,566,3248222,3248222,586,3248808
479,24,24,3255847,3256230,400,3254249,3255036,795,3255831
480,38,38,3262407,3263023,633,3261059,3261850,540,3262390
481,20,20,3269666,3269982,333,3267868,3268664,997,3269661
482,42,42,3276292,3276975,699,3274694,3275478,800,3276278
483,52,52,3283201,3284050,866,3281503,3282292,894,3283186
484,38,38,3290110,3290726,633,3288312,3289106,997,3290103
485,34,34,3296620,3297169,566,3295122,3295920,690,3296610
486,4,4,3303562,3303612,67,3301948,3302734,810,3303544
487,10,10,3310405,3310555,167,3308757,3309548,840,3310388
488,10,10,3316881,3317031,167,3315566,3316362,517,3316879
489,6,6,3323874,3323957,100,3322392,3323176,690,3323866
490,28,28,3330566,3331016,467,3329201,3329990,562,3330552
491,60,60,3337492,3338475,999,3336011,3336804,671,3337475
492,14,14,3344435,3344651,233,3342820,3343618,809,3344427
493,46,46,3351161,3351910,766,3349646,3350432,726,3351158
494,6,6,3357787,3357870,100,3356455,3357246,539,3357785
495,42,42,3364913,3365595,699,3363264,3364060,844,3364904
496,40,40,3371739,3372388,665,3370090,3370874,858,3371732
497,20,20,3378331,3378648,333,3376900,3377688,625,3378313
498,4,4,3385340,3385390,67,3383709,3384502,828,3385330
499,10,10,3392166,3392316,167,3390518,3391316,844,3392160
500,12,12,3398992,3399175,200,3397344,3398130,847,3398977
501,30,30,3405485,3405968,500,3404153,3404944,538,3405482
502,12,12,3412744,3412927,200,3410963,3411758,980,3412738
503,20,20,3419170,3419487,333,3417789,3418572,594,3419166
504,42,42,3426313,3426995,699,3424598,3425386,917,3426303
505,48,48,3432789,3433572,799,3431407,3432200,571,3432771
506,24,24,3439632,3440015,399,3438216,3439014,600,3439614
507,54,54,3446474,3447357,899,3445042,3445828,630,3446458
508,44,44,3453400,3454116,733,3451852,3452642,744,3453386
509,32,32,3460259,3460775,533,3458661,3459456,792,3460248
510,14,14,3467135,3467352,233,3465487,3466270,863,3467133
511,12,12,3474028,3474211,199,3472296,3473084,930,3474014
512,30,30,3480571,3481053,499,3479105,3479898,654,3480552
513,34,34,3487397,3487946,566,3485915,3486712,682,3487394
514,54,54,3494073,3494955,899,3492741,3493526,539,3494065
515,10,10,3501148,3501298,167,3499550,3500340,793,3501133
516,6,6,3507891,3507974,100,3506359,3507154,734,3507888
517,46,46,3514950,3515699,766,3513185,3513968,966,3514934
518,6,6,3521426,3521510,100,3519994,3520782,637,3521419
519,48,48,3528569,3529351,799,3526804,3527596,968,3528564
520,40,40,3535178,3535827,666,3533613,3534410,756,3535166
521,2,2,3541821,3541837,33,3540439,3541224,579,3541803
522,36,36,3548663,3549246,600,3547248,3548038,612,3548650
523,38,38,3555856,3556472,632,3554058,3554852,990,3555842
524,36,36,3562349,3562931,599,3560884,3561666,679,3562345
525,12,12,3569208,3569391,200,3567693,3568480,714,3569194
526,8,8,3575934,3576050,133,3574502,3575294,635,3575929
527,40,40,3583026,3583675,666,3581311,3582108,904,3583012
528,12,12,3589736,3589919,199,3588137,3588922,801,3589723
529,24,24,3596362,3596745,399,3594947,3595736,618,3596354
530,4,4,3603188,3603238,66,3601756,3602550,620,3603170
531,38,38,3610347,3610963,632,3608565,3609364,970,3610334
532,36,36,3616756,3617339,600,3615391,3616178,574,3616752
533,46,46,3623566,3624315,765,3622200,3622992,569,3623561
534,24,24,3630491,3630874,400,3629010,3629806,681,3630487
535,28,28,3637284,3637734,466,3635836,3636620,646,3637266
536,44,44,3644077,3644793,732,3642645,3643434,634,3644068
537,18,18,3651202,3651485,300,3649454,3650248,948,3651196
538,14,14,3657812,3658028,233,3656263,3657062,733,3657795
539,14,14,3664421,3664638,233,3663089,3663876,533,3664409
540,18,18,3671464,3671747,299,3669899,3670690,769,3671459
541,10,10,3678206,3678356,167,3676708,3677504,692,3678196
542,42,42,3685016,3685698,699,3683534,3684318,684,3685002
543,44,44,3691858,3692574,733,3690343,3691132,712,3691844
544,56,56,3698851,3699766,932,3697152,3697946,899,3698845
545,8,8,3705627,3705743,133,3703962,3704760,848,3705608
546,8,8,3712186,3712303,133,3710788,3711574,595,3712169
547,46,46,3719362,3720111,766,3717597,3718388,969,3719357
548,18,18,3726021,3726304,300,3724406,3725202,809,3726011
549,60,60,3732947,3733929,999,3731232,3732016,913,3732929
550,30,30,3739407,3739889,499,3738041,3738830,567,3739397
551,60,60,3746382,3747365,999,3744851,3745644,729,3746373
552,48,48,3753075,3753858,799,3751660,3752458,600,3753058
553,46,46,3760018,3760767,766,3758486,3759272,731,3760003
554,58,58,3766910,3767859,966,3765295,3766086,809,3766895
555,36,36,3773703,3774286,599,3772105,3772900,796,3773696
556,22,22,3780662,3781012,366,3778930,3779714,943,3780657
557,56,56,3787105,3788021,932,3785740,3786528,566,3787094
558,28,28,3794014,3794464,466,3792549,3793342,670,3794012
559,14,14,3800973,3801190,233,3799358,3800156,803,3800959
560,40,40,3807583,3808232,666,3806184,3806970,597,3807567
561,54,54,3814475,3815358,899,3812994,3813784,682,3814466
562,16,16,3821201,3821451,267,3819803,3820598,600,3821198
563,12,12,3827994,3828177,200,3826629,3827412,580,3827992
564,50,50,3835003,3835819,832,3833438,3834226,762,3834988
565,38,38,3841696,3842312,632,3840247,3841040,638,3841678
566,40,40,3848389,3849038,666,3847057,3847854,517,3848371
567,42,42,3855514,3856197,699,3853883,3854668,832,3855500
568,54,54,3862423,3863306,899,3860692,3861482,933,3862415
569,10,10,3868850,3869000,166,3867501,3868296,546,3868842
570,46,46,3875875,3876625,766,3874327,3875110,752,3875862
571,46,46,3882851,3883600,766,3881136,3881924,919,3882843
572,22,22,3889294,3889644,366,3887946,3888738,538,3889276
573,16,16,3896553,3896803,266,3894755,3895552,996,3896548
574,16,16,3903246,3903495,266,3901581,3902366,866,3903232
575,56,56,3909805,3910721,933,3908390,3909180,608,3909788
576,38,38,3916848,3917464,632,3915199,3915994,841,3916835
577,22,22,3923574,3923923,366,3922025,3922808,757,3923565
578,54,54,3930316,3931199,899,3928835,3929622,688,3930310
579,36,36,3937276,3937858,599,3935644,3936436,837,3937273
580,24,24,3943918,3944301,400,3942453,3943250,659,3943909
581,20,20,3950927,3951244,333,3949279,3950064,859,3950923
582,32,32,3957587,3958103,533,3956088,3956878,706,3957584
583,58,58,3964213,3965162,966,3962898,3963692,518,3964210
584,22,22,3971189,3971538,366,3969707,3970506,676,3971182
585,46,46,3977931,3978681,766,3976533,3977320,609,3977929
586,16,16,3985057,3985307,266,3983342,3984134,910,3985044
587,54,54,3991883,3992765,899,3990152,3990948,919,3991867
588,16,16,3998493,3998742,266,3996977,3997762,717,3998479
589,14,14,4005268,4005485,234,4003787,4004576,682,4005258
590,8,8,4012228,4012344,133,4010596,4011390,819,4012209
591,38,38,4019054,4019670,632,4017405,4018204,835,4019039
592,36,36,4025946,4026529,599,4024231,4025018,924,4025942
593,58,58,4032489,4033438,966,4031041,4031832,646,4032478
594,32,32,4039332,4039848,532,4037850,4038646,674,4039320
595,12,12,4046191,4046374,200,4044676,4045460,727,4046187
596,22,22,4053033,4053383,367,4051485,4052274,753,4053027
597,14,14,4060042,4060259,234,4058294,4059088,942,4060030
598,34,34,4066485,4067035,567,4065104,4065902,572,4066474
599,26,26,4073561,4073977,433,4071930,4072716,838,4073554
600,48,48,4080387,4081170,799,4078739,4079530,850,4080380
601,48,48,4086997,4087779,799,4085548,4086344,644,4086988
602,8,8,4093956,4094072,133,4092374,4093158,791,4093949
603,60,60,4100499,4101481,999,4099183,4099972,523,4100495
604,56,56,4107474,4108390,933,4105993,4106786,675,4107461
605,18,18,4114384,4114667,299,4112802,4113600,766,4114366
606,24,24,4121026,4121409,400,4119628,4120414,600,4121014
607,32,32,4127736,4128252,533,4126437,4127228,501,4127729
608,18,18,4134760,4135043,300,4133245,4134042,702,4134744
609,28,28,4141603,4142053,466,4140071,4140856,742,4141598
610,44,44,4148279,4148995,733,4146881,4147670,602,4148272
611,18,18,4155338,4155621,300,4153690,4154484,837,4155321
612,38,38,4162214,4162830,633,4160499,4161298,898,4162196
613,6,6,4168624,4168707,100,4167325,4168112,502,4168614
614,26,26,4175516,4175932,433,4174134,4174926,587,4175513
615,58,58,4182742,4183691,965,4180944,4181740,993,4182733
616,34,34,4189385,4189934,566,4187770,4188554,826,4189380
617,52,52,4196094,4196943,866,4194579,4195368,718,4196086
618,16,16,4202770,4203020,266,4201388,4202182,583,4202765
619,38,38,4209812,4210428,633,4208198,4208996,812,4209808
620,60,60,4216505,4217487,999,4215023,4215810,678,4216488
621,6,6,4223381,4223464,100,4221833,4222624,748,4223372
622,52,52,4230274,4231123,865,4228642,4229438,825,4230263
623,6,6,4236833,4236916,100,4235468,4236252,578,4236830
624,14,14,4243909,4244125,233,4242277,4243066,836,4243902
625,60,60,4250385,4251367,999,4249087,4249880,503,4250383
626,36,36,4257544,4258127,599,4255896,4256694,841,4257535
627,52,52,4264170,4265019,866,4262722,4263508,659,4264167
628,50,50,4270996,4271812,833,4269531,4270322,663,4270985
629,16,16,4277889,4278138,266,4276340,4277136,737,4277873
630,2,2,4284864,4284881,34,4283166,4283950,899,4284849
631,8,8,4291724,4291840,133,4289976,4290764,952,4291716
632,24,24,4298583,4298966,399,4296785,4297578,989,4298567
633,34,34,4305209,4305758,566,4303594,4304392,806,4305198
634,20,20,4312168,4312484,333,4310420,4311206,955,4312161
635,54,54,4318778,4319660,899,4317229,4318020,750,4318770
636,54,54,4325387,4326270,899,4324039,4324834,541,4325375
637,28,28,4332313,4332762,466,4330865,4331648,647,4332295
638,20,20,4339339,4339655,333,4337674,4338462,871,4339333
639,38,38,4346065,4346681,632,4344483,4345276,785,4346061
640,44,44,4352841,4353557,732,4351292,4352090,738,4352828
641,58,58,4359600,4360549,966,4358118,4358904,687,4359591
642,2,2,4366426,4366443,33,4364928,4365718,693,4366411
643,38,38,4373085,4373701,633,4371737,4372532,547,4373079
644,22,22,4380045,4380394,366,4378563,4379346,690,4380036
645,38,38,4386687,4387303,633,4385372,4386160,509,4386669
646,12,12,4393663,4393846,200,4392181,4392974,671,4393645
647,14,14,4400406,4400622,233,4398991,4399788,605,4400393
648,32,32,4407415,4407931,533,4405817,4406602,809,4407411
649,54,54,4413991,4414873,899,4412626,4413416,568,4413984
650,18,18,4420900,4421183,300,4419435,4420230,656,4420886
651,26,26,4428043,4428459,432,4426261,4427044,989,4428033
652,46,46,4434452,4435201,766,4433070,4433858,583,4434441
653,34,34,4441212,4441761,566,4439880,4440672,524,4441196
654,28,28,4448237,4448687,467,4446689,4447486,749,4448235
655,22,22,4454980,4455330,366,4453515,4454300,665,4454965
656,12,12,4461773,4461956,199,4460324,4461114,651,4461765
657,54,54,4468798,4469681,899,4467134,4467928,866,4468794
658,60,60,4475474,4476457,999,4473959,4474742,721,4475463
659,2,2,4482151,4482167,33,4480769,4481556,577,4482133
660,32,32,4489260,4489776,532,4487578,4488370,877,4489247
661,30,30,4495736,4496219,499,4494387,4495184,544,4495728
662,48,48,4502978,4503760,799,4501213,4501998,977,4502975
663,22,22,4509721,4510070,366,4508023,4508812,902,4509714
664,22,22,4516147,4516497,366,4514832,4515626,507,4516133
665,14,14,4523056,4523273,233,4521641,4522440,598,4523038
666,48,48,4529949,4530731,799,4528467,4529254,686,4529940
667,28,28,4536891,4537341,466,4535276,4536068,805,4536873
668,38,38,4543867,4544483,633,4542086,4542882,972,4543854
669,46,46,4550543,4551292,766,4548912,4549696,844,4550540
670,50,50,4557136,4557952,832,4555721,4556510,611,4557121
671,14,14,4564328,4564545,233,4562530,4563324,986,4564310
672,40,40,4570921,4571570,666,4569339,4570138,781,4570919
673,36,36,4577830,4578413,600,4576165,4576952,870,4577822
674,42,42,4584656,4585339,699,4582975,4583766,872,4584638
675,28,28,4591182,4591632,467,4589784,4590580,593,4591173
676,28,28,4598258,4598708,466,4596610,4597394,851,4598245
677,60,60,4605134,4606116,999,4603419,4604208,912,4605120
678,14,14,4611544,4611760,233,4610228,4611022,518,4611540
679,36,36,4618370,4618952,599,4617038,4617836,522,4618358
680,32,32,4625162,4625678,533,4623864,4624650,502,4625152
681,38,38,4632205,4632821,632,4630673,4631464,733,4632197
682,32,32,4638914,4639430,533,4637482,4638278,624,4638902
683,2,2,4645657,4645673,33,4644308,4645092,562,4645654
684,6,6,4652449,4652533,100,4651117,4651906,537,4652443
685,58,58,4659425,4660374,966,4657927,4658720,703,4659423
686,38,38,4666201,4666817,633,4664736,4665534,654,4666188
687,36,36,4673127,4673710,599,4671562,4672348,770,4673118
688,54,54,4679803,4680685,899,4678371,4679162,633,4679795
689,42,42,4686962,4687644,699,4685180,4685976,983,4686959
690,24,24,4693738,4694121,399,4692006,4692790,939,4693729
691,22,22,4700381,4700730,366,4698816,4699604,767,4700371
692,22,22,4707323,4707673,366,4705625,4706418,903,4707321
693,32,32,4713983,4714499,532,4712434,4713232,739,4713971
694,12,12,4721008,4721191,200,4719260,4720046,948,4720994
695,40,40,4727701,4728350,666,4726070,4726860,832,4727692
696,30,30,4734444,4734927,499,4732879,4733674,765,4734439
697,28,28,4741153,4741603,466,4739705,4740488,655,4741143
698,40,40,4748162,4748812,666,4746514,4747302,852,4748154
699,60,60,4754905,4755887,999,4753323,4754116,778,4754894
700,60,60,4761847,4762830,999,4760133,4760930,902,4761832
701,20,20,4768690,4769006,333,4766959,4767744,931,4768675
702,48,48,4775250,4776032,799,4773768,4774558,684,4775242
703,42,42,4781892,4782575,700,4780577,4781372,517,4781889
704,60,60,4789168,4790150,999,4787403,4788186,976,4789162
705,38,38,4795827,4796443,633,4794212,4795000,825,4795825
706,50,50,4802753,4803569,833,4801022,4801814,922,4802736
707,32,32,4809579,4810095,533,4807831,4808628,949,4809577
708,58,58,4816405,4817354,966,4814657,4815442,959,4816401
709,58,58,4823214,4824163,966,4821466,4822256,945,4823201
710,6,6,4829757,4829840,100,4828275,4829070,676,4829746
711,36,36,4836533,4837116,599,4835101,4835884,638,4836522
712,60,60,4843592,4844574,999,4841911,4842698,892,4843590
713,54,54,4850351,4851234,900,4848720,4849512,826,4850338
714,50,50,4856911,4857727,832,4855529,4856326,582,4856908
715,8,8,4863903,4864020,134,4862355,4863140,752,4863892
716,12,12,4870896,4871079,200,4869164,4869954,936,4870890
717,16,16,4877322,4877572,267,4875974,4876768,548,4877316
718,44,44,4884448,4885164,732,4882783,4883582,850,4884432
719,52,52,4891307,4892156,866,4889609,4890396,896,4891292
720,42,42,4898066,4898749,700,4896418,4897210,851,4898061
721,22,22,4904826,4905175,366,4903227,4904024,792,4904816
722,2,2,4911785,4911802,33,4910053,4910838,939,4911777
723,36,36,4918528,4919110,599,4916863,4917652,872,4918524
724,28,28,4925220,4925670,466,4923672,4924466,744,4925210
725,26,26,4932013,4932429,433,4930481,4931280,719,4931999
726,6,6,4938722,4938806,100,4937307,4938094,618,4938712
727,16,16,4945432,4945681,266,4944116,4944908,506,4945414
728,50,50,4952274,4953090,833,4950926,4951722,544,4952266
729,60,60,4959333,4960316,999,4957752,4958536,782,4959318
730,54,54,4966043,4966925,899,4964561,4965350,678,4966028
731,18,18,4973018,4973302,300,4971370,4972164,843,4973007
732,44,44,4979495,4980211,732,4978180,4978978,504,4979482
733,28,28,4986770,4987220,466,4985006,4985792,966,4986758
734,26,26,4993280,4993696,433,4991815,4992606,662,4993268
735,48,48,5000272,5001055,799,4998624,4999420,840,5000260
736,54,54,5006965,5007847,899,5005450,5006234,725,5006959
737,30,30,5013641,5014124,500,5012259,5013048,590,5013638
738,18,18,5020434,5020717,299,5019069,5019862,564,5020426
739,14,14,5027343,5027559,233,5025878,5026676,651,5027327
740,40,40,5034186,5034835,665,5032704,5033490,693,5034183
741,42,42,5041228,5041910,699,5039513,5040304,912,5041216
742,10,10,5047954,5048104,166,5046322,5047118,823,5047941
743,4,4,5054464,5054513,66,5053148,5053932,520,5054452
744,6,6,5061672,5061756,100,5059958,5060746,923,5061669
745,52,52,5068365,5069214,866,5066767,5067560,798,5068358
746,12,12,5074958,5075141,200,5073576,5074374,576,5074950
747,50,50,5082000,5082816,833,5080402,5081188,808,5081996
748,22,22,5088693,5089043,366,5087211,5088002,688,5088690
749,36,36,5095719,5096302,599,5094021,5094816,893,5095709
750,18,18,5102561,5102844,300,5100847,5101630,924,5102554
751,60,60,5108988,5109970,999,5107656,5108444,529,5108973
752,4,4,5116230,5116280,67,5114465,5115258,962,5116220
753,54,54,5122839,5123722,899,5121274,5122072,753,5122825
754,16,16,5129732,5129982,266,5128100,5128886,836,5129722
755,32,32,5136558,5137074,533,5134910,5135700,848,5136548
756,34,34,5143251,5143800,566,5141719,5142514,731,5143245
757,58,58,5150127,5151075,965,5148545,5149328,793,5150121
758,12,12,5156986,5157169,200,5155354,5156142,831,5156973
759,24,24,5163878,5164261,400,5162163,5162956,919,5163875
760,32,32,5170521,5171037,533,5168973,5169770,746,5170516
761,34,34,5177247,5177797,566,5175799,5176584,661,5177245
762,18,18,5183990,5184273,300,5182608,5183398,580,5183978
763,42,42,5191032,5191715,699,5189417,5190212,802,5191014
764,8,8,5197991,5198108,134,5196243,5197026,957,5197983
765,46,46,5204434,5205184,766,5203052,5203840,579,5204419
766,8,8,5211244,5211360,133,5209862,5210654,582,5211236
767,16,16,5218452,5218702,267,5216671,5217468,968,5218436
768,18,18,5224995,5225278,300,5223497,5224282,700,5224982
769,10,10,5231671,5231821,167,5230306,5231096,559,5231655
770,52,52,5238514,5239363,866,5237116,5237910,586,5238496
771,52,52,5245690,5246539,865,5243941,5244724,963,5245687
772,4,4,5252416,5252466,66,5250751,5251538,864,5252402
773,28,28,5259125,5259575,466,5257560,5258352,757,5259109
774,16,16,5265701,5265951,267,5264369,5265166,531,5265697
775,16,16,5272677,5272927,266,5271195,5271980,681,5272661
776,48,48,5279453,5280235,799,5278005,5278794,655,5279449
777,50,50,5286346,5287161,832,5284814,5285608,734,5286342
778,54,54,5292988,5293871,899,5291623,5292422,554,5292976
779,58,58,5300081,5301030,965,5298449,5299236,829,5300065
780,40,40,5306990,5307639,666,5305258,5306050,926,5306976
781,44,44,5313816,5314532,732,5312068,5312864,938,5313802
782,42,42,5320325,5321008,700,5318894,5319678,631,5320309
783,20,20,5327118,5327434,333,5325703,5326492,613,5327105
784,14,14,5334044,5334260,233,5332512,5333306,735,5334041
785,24,24,5340970,5341353,399,5339321,5340120,847,5340967
786,6,6,5347496,5347579,100,5346147,5346934,544,5347478
787,32,32,5354255,5354771,533,5352957,5353748,504,5354252
788,48,48,5361181,5361964,799,5359766,5360562,605,5361167
789,42,42,5368124,5368806,699,5366592,5367376,729,5368105
790,40,40,5375016,5375665,666,5373401,5374190,818,5375008
791,38,38,5381509,5382125,633,5380210,5381004,501,5381505
792,22,22,5388751,5389101,366,5387020,5387818,923,5388741
793,54,54,5395577,5396460,899,5393846,5394632,938,5395570
794,50,50,5402220,5403036,832,5400655,5401446,766,5402212
795,32,32,5408913,5409429,532,5407464,5408260,647,5408907
796,38,38,5415705,5416321,633,5414290,5415074,625,5415699
797,2,2,5422565,5422581,33,5421099,5421888,658,5422546
798,30,30,5429440,5429923,500,5427909,5428702,724,5429426
799,48,48,5436150,5436932,799,5434718,5435516,621,5436137
800,8,8,5443042,5443159,134,5441544,5442330,706,5443036
801,34,34,5449952,5450501,566,5448353,5449144,790,5449934
802,52,52,5456561,5457410,866,5455163,5455958,588,5456546
803,26,26,5463470,5463886,433,5461988,5462772,681,5463453
804,16,16,5470096,5470346,267,5468798,5469586,500,5470086
805,58,58,5477255,5478204,966,5475607,5476400,841,5477241
806,28,28,5484214,5484664,467,5482416,5483214,992,5484206
807,16,16,5490890,5491140,267,5489242,5490028,855,5490883
808,18,18,5497750,5498033,299,5496052,5496842,890,5497732
809,4,4,5504609,5504659,67,5502861,5503656,939,5504595
810,18,18,5511285,5511568,300,5509687,5510470,800,5511270
811,38,38,5518244,5518860,633,5516496,5517284,947,5518231
812,38,38,5524987,5525603,633,5523305,5524098,878,5524976
813,46,46,5531463,5532212,766,5530115,5530912,538,5531450
814,24,24,5538256,5538639,399,5536941,5537726,525,5538251
815,56,56,5545448,5546364,932,5543750,5544540,894,5545434
816,4,4,5552341,5552390,66,5550559,5551354,980,5552334
817,60,60,5558684,5559666,999,5557385,5558168,513,5558681
818,14,14,5565626,5565843,233,5564194,5564982,630,5565612
819,2,2,5572685,5572702,33,5571004,5571796,886,5572682
820,58,58,5579444,5580393,966,5577813,5578610,816,5579426
821,38,38,5585987,5586603,633,5584639,5585424,547,5585971
822,16,16,5593113,5593363,266,5591448,5592238,858,5593096
823,22,22,5599789,5600139,366,5598257,5599052,728,5599780
824,26,26,5606732,5607148,432,5605083,5605866,858,5606724
825,20,20,5613258,5613574,333,5611893,5612680,561,5613241
826,48,48,5620367,5621149,799,5618702,5619494,869,5620363
827,2,2,5627243,5627259,33,5625511,5626308,932,5627240
828,28,28,5633919,5634368,466,5632337,5633122,791,5633913
829,8,8,5640578,5640695,133,5639146,5639936,627,5640563
830,52,52,5647504,5648353,866,5645956,5646750,740,5647490
831,52,52,5654496,5655346,866,5652765,5653564,925,5654489
832,16,16,5661239,5661489,267,5659591,5660378,850,5661228
833,28,28,5668165,5668615,466,5666400,5667192,960,5668152
834,28,28,5674575,5675024,466,5673210,5674006,558,5674564
835,44,44,5681684,5682400,732,5680035,5680820,857,5681677
836,50,50,5688626,5689442,833,5686845,5687634,974,5688608
837,14,14,5695169,5695385,233,5693654,5694448,714,5695162
838,8,8,5701878,5701995,134,5700463,5701262,599,5701861
839,28,28,5708987,5709437,467,5707289,5708076,896,5708972
840,38,38,5715597,5716213,633,5714099,5714890,700,5715590
841,4,4,5722439,5722489,67,5720908,5721704,722,5722426
842,56,56,5729199,5730115,932,5727734,5728518,675,5729193
843,44,44,5735908,5736624,733,5734543,5735332,565,5735897
844,60,60,5743067,5744049,999,5741352,5742146,912,5743058
845,52,52,5749960,5750809,865,5748162,5748960,995,5749955
846,10,10,5756786,5756935,166,5754988,5755774,997,5756771
847,44,44,5763279,5763994,732,5761797,5762588,675,5763263
848,14,14,5770238,5770454,233,5768606,5769402,824,5770226
849,46,46,5777114,5777863,765,5775432,5776216,882,5777098
850,6,6,5784039,5784123,100,5782241,5783030,994,5784024
851,8,8,5790383,5790499,133,5789051,5789844,532,5790376
852,20,20,5797392,5797708,333,5795860,5796658,720,5797378
853,54,54,5804384,5805266,899,5802686,5803472,895,5804367
854,38,38,5810944,5811560,632,5809495,5810286,639,5810925
855,54,54,5817869,5818752,899,5816304,5817100,761,5817861
856,6,6,5824795,5824878,100,5823130,5823914,875,5824789
857,48,48,5831338,5832121,799,5829940,5830728,592,5831320
858,52,52,5838547,5839396,866,5836749,5837542,988,5838530
859,34,34,5845206,5845756,566,5843558,5844356,832,5845188
860,30,30,5852149,5852632,499,5850384,5851170,971,5852141
861,10,10,5858542,5858692,166,5857193,5857984,549,5858533
862,32,32,5865568,5866084,532,5864003,5864798,756,5865554
863,32,32,5872161,5872677,532,5870829,5871612,534,5872146
864,48,48,5879136,5879919,799,5877638,5878426,707,5879133
865,6,6,5885962,5886045,100,5884447,5885240,716,5885956
866,30,30,5892888,5893371,500,5891257,5892054,829,5892883
867,50,50,5899564,5900380,833,5898082,5898868,678,5899546
868,12,12,5906623,5906806,200,5904892,5905682,931,5906613
869,30,30,5913099,5913582,500,5911701,5912496,586,5913082
870,4,4,5920225,5920275,67,5918527,5919310,902,5920212
871,54,54,5927001,5927883,899,5925336,5926124,861,5926985
872,38,38,5933677,5934293,633,5932146,5932938,726,5933664
873,26,26,5940736,5941152,433,5938955,5939752,979,5940731
874,48,48,5947379,5948161,799,5945781,5946566,810,5947376
875,50,50,5954222,5955037,832,5952590,5953380,838,5954218
876,42,42,5961114,5961797,699,5959399,5960194,910,5961104
877,60,60,5967890,5968872,999,5966225,5967008,877,5967885
878,14,14,5974566,5974783,233,5973035,5973822,737,5974559
879,54,54,5981542,5982424,899,5979844,5980636,902,5981538
880,10,10,5988351,5988501,167,5986653,5987450,894,5988344
881,38,38,5995194,5995810,633,5993479,5994264,912,5995176
882,50,50,6001887,6002702,832,6000288,6001078,792,6001870
883,52,52,6008529,6009378,866,6007098,6007892,634,6008526
884,14,14,6015389,6015605,233,6013924,6014706,665,6015371
885,56,56,6022281,6023197,932,6020733,6021520,754,6022274
886,24,24,6028957,6029340,400,6027542,6028334,620,6028954
887,14,14,6035933,6036149,233,6034351,6035148,767,6035915
888,34,34,6042526,6043075,566,6041177,6041962,555,6042517
889,46,46,6049502,6050251,765,6047987,6048776,716,6049492
890,14,14,6056344,6056561,233,6054796,6055590,743,6056333
891,48,48,6063387,6064169,799,6061605,6062404,973,6063377
892,58,58,6069996,6070945,966,6068431,6069218,776,6069994
893,54,54,6076572,6077455,899,6075240,6076032,533,6076565
894,46,46,6083831,6084580,766,6082050,6082846,969,6083815
895,60,60,6090357,6091340,999,6088876,6089660,690,6090350
896,38,38,6097083,6097699,633,6095685,6096474,604,6097078
897,58,58,6104292,6105241,966,6102494,6103288,989,6104277
898,32,32,6111002,6111518,532,6109303,6110102,895,6110997
899,60,60,6117045,6118027,999,6116129,6116133,908,6117041
900,28,28,6123738,6124187,466,6122156,6122947,775,6123722
901,4,4,6130680,6130730,67,6128966,6129761,905,6130666
902,58,58,6137573,6138522,965,6135791,6136575,982,6137557
903,46,46,6144365,6145115,766,6142601,6143389,969,6144358
904,22,22,6150908,6151258,367,6149410,6150203,697,6150900
905,28,28,6157734,6158184,467,6156219,6157017,708,6157725
906,20,20,6164660,6164976,333,6163045,6163831,817,6164648
907,24,24,6171320,6171703,399,6169855,6170645,663,6171308
908,36,36,6178245,6178828,600,6176664,6177459,780,6178239
909,18,18,6185138,6185421,300,6183490,6184273,862,6185135
910,20,20,6191964,6192280,333,6190299,6191087,870,6191957
911,8,8,6198457,6198573,133,6197108,6197901,540,6198441
912,16,16,6205533,6205782,266,6203918,6204715,812,6205527
913,6,6,6212392,6212475,100,6210744,6211529,857,6212386
914,52,52,6219218,6220067,865,6217553,6218343,861,6219204
915,46,46,6226010,6226760,766,6224362,6225157,843,6226000
916,44,44,6232820,6233535,732,6231188,6231971,833,6232804
917,2,2,6239579,6239596,33,6237997,6238785,785,6239570
918,10,10,6246555,6246705,166,6244807,6245599,945,6246544
919,4,4,6252948,6252998,66,6251616,6252413,532,6252945
920,30,30,6260223,6260706,500,6258442,6259227,979,6260206
921,38,38,6266633,6267249,633,6265251,6266041,587,6266628
922,50,50,6273675,6274491,833,6272060,6272855,803,6273658
923,30,30,6280285,6280768,499,6278886,6279669,610,6280279
924,60,60,6287377,6288359,999,6285696,6286483,892,6287375
925,2,2,6294103,6294120,33,6292505,6293297,798,6294095
926,20,20,6300863,6301179,333,6299314,6300111,738,6300849
927,8,8,6307705,6307822,133,6306140,6306925,771,6307696
928,2,2,6314431,6314448,33,6312949,6313739,675,6314414
929,26,26,6321523,6321940,433,6319759,6320553,968,6321521
930,56,56,6327151,6328066,932,6326568,6326584,561,6327145
931,26,26,6334193,6334609,433,6332611,6333398,777,6334175
932,6,6,6340753,6340836,100,6339421,6340212,534,6340746
933,58,58,6347812,6348761,965,6346230,6347026,767,6347793
934,52,52,6354704,6355553,866,6353056,6353840,859,6354699
935,20,20,6361180,6361497,333,6359865,6360654,513,6361167
936,44,44,6368356,6369072,733,6366675,6367468,880,6368348
937,44,44,6374882,6375598,733,6373484,6374282,591,6374873
938,56,56,6382074,6382990,933,6380310,6381096,964,6382060
939,4,4,6388801,6388850,66,6387119,6387910,885,6388795
940,4,4,6395726,6395776,67,6393928,6394724,988,6395712
941,24,24,6402269,6402652,400,6400754,6401538,716,6402254
942,20,20,6409079,6409395,333,6407564,6408352,711,6409063
943,16,16,6415988,6416237,266,6414373,6415166,812,6415978
944,44,44,6422680,6423396,733,6421182,6421980,688,6422668
945,26,26,6429340,6429756,433,6428008,6428794,530,6429324
946,36,36,6436599,6437181,599,6434817,6435608,986,6436594
947,42,42,6443225,6443907,699,6441627,6442422,797,6443219
948,8,8,6450101,6450217,133,6448453,6449236,857,6450093
949,54,54,6456927,6457809,899,6455262,6456050,860,6456910
950,36,36,6463569,6464152,600,6462071,6462864,699,6463563
951,10,10,6470545,6470695,167,6468880,6469678,849,6470527
952,24,24,6477055,6477438,399,6475706,6476492,548,6477040
953,16,16,6484147,6484397,267,6482516,6483306,837,6484143
954,26,26,6490807,6491223,433,6489325,6490120,670,6490790
955,6,6,6497499,6497583,100,6496151,6496934,561,6497495
956,60,60,6504575,6505557,999,6502960,6503748,816,6504564
957,56,56,6511185,6512100,932,6509769,6510562,620,6511182
958,46,46,6517977,6518726,766,6516579,6517376,596,6517972
959,12,12,6524953,6525136,200,6523405,6524190,756,6524946
960,16,16,6531979,6532228,266,6530214,6531004,969,6531973
961,28,28,6538372,6538821,466,6537023,6537818,547,6538365
962,42,42,6545514,6546197,699,6543849,6544632,872,6545504
963,4,4,6552357,6552407,66,6550658,6551446,893,6552339
964,28,28,6559116,6559565,466,6557468,6558260,842,6559102
965,60,60,6565925,6566907,999,6564277,6565074,846,6565920
966,40,40,6572751,6573400,666,6571103,6571888,850,6572738
967,40,40,6579277,6579927,666,6577912,6578702,570,6579272
968,10,10,6586386,6586536,167,6584721,6585516,868,6586384
969,46,46,6593129,6593878,766,6591547,6592330,794,6593124
970,46,46,6599805,6600554,766,6598357,6599144,652,6599796
971,50,50,6606564,6607380,833,6605166,6605958,593,6606551
972,18,18,6613324,6613607,300,6611975,6612772,536,6613308
973,14,14,6620499,6620716,233,6618801,6619586,895,6620481
974,58,58,6627392,6628341,966,6625611,6626400,979,6627379
975,22,22,6633718,6634068,367,6632420,6633214,502,6633716
976,40,40,6640794,6641443,666,6639229,6640028,755,6640783
977,4,4,6647520,6647570,67,6646055,6646842,674,6647516
978,12,12,6654279,6654463,200,6652864,6653656,615,6654271
979,60,60,6661372,6662354,999,6659674,6660470,886,6661356
980,58,58,6668181,6669130,966,6666500,6667284,881,6668165
981,22,22,6674706,6675056,367,6673308,6674098,606,6674704
982,58,58,6681532,6682481,966,6680117,6680912,611,6681523
983,18,18,6688608,6688891,300,6686943,6687726,869,6688595
984,22,22,6695251,6695600,366,6693752,6694540,699,6695239
985,4,4,6702110,6702160,67,6700562,6701354,743,6702097
986,46,46,6709019,6709768,766,6707371,6708168,848,6709016
987,24,24,6715778,6716161,400,6714197,6714982,779,6715761
988,22,22,6722371,6722721,367,6721006,6721796,562,6722358
989,12,12,6729613,6729797,200,6727815,6728610,997,6729607
990,10,10,6736423,6736573,166,6734641,6735424,983,6736407
991,60,60,6742866,6743848,999,6741451,6742238,614,6742852
992,36,36,6749775,6750358,599,6748260,6749052,708,6749760
993,36,36,6756717,6757300,600,6755069,6755866,838,6756704
994,60,60,6763393,6764376,999,6761895,6762680,709,6763389
995,36,36,6770303,6770885,599,6768704,6769494,806,6770300
996,52,52,6776829,6777678,866,6775514,6776308,513,6776821
997,38,38,6783838,6784454,633,6782323,6783122,712,6783834
998,12,12,6790531,6790714,200,6789149,6789936,587,6790523
999,36,36,6797623,6798206,599,6795958,6796750,862,6797612
1000,4,4,6804332,6804382,67,6802767,6803564,763,6804327
1001,26,26,6811009,6811425,432,6809593,6810378,627,6811005
1002,56,56,6818034,6818950,933,6816403,6817192,827,6818019
1003,40,40,6824960,6825609,666,6823212,6824006,951,6824957
1004,38,38,6831570,6832186,632,6830021,6830820,747,6831567
1005,42,42,6838529,6839211,699,6836847,6837634,888,6838522
1006,18,18,6845105,6845388,300,6843656,6844448,642,6845090
1007,2,2,6852164,6852181,33,6850466,6851262,887,6852149
1008,18,18,6858907,6859190,299,6857292,6858076,823,6858899
1009,44,44,6865533,6866249,732,6864101,6864890,625,6865515
1010,6,6,6872442,6872525,100,6870910,6871704,733,6872437
1011,8,8,6879151,6879268,134,6877720,6878518,625,6879143
1012,52,52,6886144,6886993,866,6884546,6885332,794,6886126
1013,2,2,6893120,6893136,33,6891355,6892146,971,6893117
1014,8,8,6899479,6899596,134,6898164,6898960,513,6899473
1015,16,16,6906622,6906871,266,6904990,6905774,841,6906615
1016,8,8,6913431,6913547,133,6911799,6912588,835,6913423
1017,24,24,6920407,6920790,399,6918609,6919402,988,6920390
1018,48,48,6927166,6927948,799,6925418,6926216,934,6927150
1019,20,20,6933959,6934275,333,6932244,6933030,915,6933945
1020,48,48,6940785,6941567,799,6939053,6939844,925,6940769
1021,22,22,6947477,6947827,367,6945862,6946658,802,6947460
1022,60,60,6954353,6955335,999,6952688,6953472,863,6954335
1023,30,30,6960929,6961412,500,6959498,6960286,640,6960926
1024,38,38,6967922,6968538,632,6966307,6967100,812,6967912
1025,22,22,6974714,6975064,367,6973116,6973914,789,6974703
1026,56,56,6981324,6982240,932,6979942,6980728,581,6981309
1027,48,48,6988233,6989016,799,6986751,6987542,687,6988229
1028,30,30,6994876,6995359,499,6993561,6994356,506,6994862
1029,32,32,7002101,7002618,533,7000387,7001170,929,7002099
1030,12,12,7008944,7009127,200,7007196,7007984,950,7008934
1031,60,60,7015354,7016336,999,7014005,7014798,540,7015338
1032,38,38,7022163,7022779,633,7020814,7021612,538,7022150
1033,42,42,7029089,7029771,699,7027640,7028426,649,7029075
1034,8,8,7036148,7036264,133,7034450,7035240,899,7036139
1035,10,10,7042757,7042907,167,7041259,7042054,694,7042748
1036,50,50,7049483,7050299,833,7048085,7048868,601,7049469
1037,24,24,7056426,7056809,399,7054894,7055682,727,7056409
1038,20,20,7063318,7063635,333,7061703,7062496,807,7063303
1039,42,42,7070228,7070910,699,7068513,7069310,910,7070220
1040,12,12,7076970,7077153,200,7075339,7076124,843,7076967
1041,50,50,7083596,7084412,833,7082148,7082938,650,7083588
1042,46,46,7090622,7091371,766,7088957,7089752,863,7090615
1043,22,22,7097415,7097764,366,7095783,7096566,837,7097403
1044,44,44,7104374,7105090,732,7102592,7103380,989,7104369
1045,26,26,7111150,7111566,433,7109402,7110194,950,7111144
1046,10,10,7117793,7117943,166,7116211,7117008,775,7117783
1047,52,52,7124719,7125568,865,7123037,7123822,882,7124704
1048,8,8,7131395,7131511,133,7129846,7130636,745,7131381
1049,36,36,7138087,7138670,600,7136656,7137450,633,7138083
1050,26,26,7145013,7145429,433,7143481,7144264,734,7144998
1051,20,20,7151939,7152255,333,7150291,7151078,846,7151924
1052,56,56,7158698,7159614,933,7157100,7157892,798,7158690
1053,2,2,7165491,7165508,33,7163909,7164706,770,7165476
1054,36,36,7172300,7172883,600,7170735,7171520,763,7172283
1055,50,50,7179060,7179875,832,7177545,7178334,707,7179041
1056,52,52,7186069,7186918,865,7184354,7185148,911,7186059
1057,56,56,7192861,7193777,933,7191163,7191962,888,7192850
1058,10,10,7199288,7199438,166,7197989,7198776,501,7199277
1059,26,26,7206480,7206896,433,7204798,7205590,886,7206476
1060,60,60,7213189,7214172,999,7211608,7212404,772,7213176
1061,20,20,7219749,7220065,333,7218434,7219218,517,7219735
1062,42,42,7226658,7227341,699,7225243,7226032,618,7226650
1063,6,6,7233767,7233850,100,7232052,7232846,909,7233755
1064,28,28,7240426,7240876,467,7238861,7239660,756,7240416
1065,18,18,7247003,7247286,299,7245687,7246474,525,7246999
1066,34,34,7254195,7254744,566,7252497,7253288,890,7254178
1067,24,24,7261071,7261454,399,7259306,7260102,959,7261061
1068,46,46,7267714,7268463,765,7266132,7266916,794,7267710
1069,24,24,7274739,7275122,400,7272941,7273730,996,7274726
1070,58,58,7281199,7282148,966,7279750,7280544,648,7281192
1071,14,14,7288108,7288324,233,7286560,7287358,739,7288097
1072,28,28,7295184,7295633,466,7293386,7294172,994,7295166
1073,18,18,7301643,7301926,300,7300195,7300986,652,7301638
1074,44,44,7308453,7309169,732,7307004,7307800,637,7308437
1075,10,10,7315412,7315562,166,7313830,7314614,794,7315408
1076,4,4,7322188,7322238,66,7320639,7321428,748,7322176
1077,58,58,7329097,7330046,966,7327449,7328242,840,7329082
1078,8,8,7335590,7335706,133,7334258,7335056,516,7335572
1079,60,60,7342716,7343698,998,7341084,7341870,842,7342712
1080,40,40,7349225,7349874,666,7347893,7348684,526,7349210
1081,26,26,7356434,7356850,433,7354703,7355498,933,7356431
1082,18,18,7363044,7363327,299,7361528,7362312,728,7363040
1083,26,26,7369903,7370319,433,7368338,7369126,769,7369895
1084,14,14,7376779,7376995,233,7375147,7375940,828,7376768
1085,24,24,7383538,7383921,400,7381956,7382754,778,7383532
1086,40,40,7390464,7391113,666,7388782,7389568,891,7390459
1087,12,12,7396923,7397107,200,7395592,7396382,532,7396914
1088,26,26,7404099,7404515,433,7402401,7403196,901,7404097
1089,14,14,7410925,7411141,233,7409227,7410010,904,7410914
1090,58,58,7417601,7418550,966,7416036,7416824,768,7417592
1091,58,58,7424444,7425393,965,7422845,7423638,795,7424433
1092,12,12,7431170,7431353,199,7429655,7430452,714,7431166
1093,60,60,7438262,7439244,999,7436481,7437266,993,7438259
1094,38,38,7444888,7445504,633,7443290,7444080,805,7444885
1095,40,40,7451531,7452180,666,7450099,7450894,632,7451526
1096,24,24,7458407,7458790,399,7456925,7457708,684,7458392
1097,42,42,7465482,7466165,700,7463734,7464522,946,7465468
1098,48,48,7472258,7473041,800,7470544,7471336,920,7472256
1099,32,32,7478768,7479284,533,7477353,7478150,603,7478753
1100,42,42,7485977,7486660,699,7484179,7484964,996,7485960
1101,46,46,7492720,7493469,765,7490988,7491778,935,7492713
1102,16,16,7499462,7499712,267,7497797,7498592,866,7499458
1103,22,22,7505972,7506322,366,7504623,7505406,558,7505964
1104,54,54,7512864,7513747,899,7511433,7512220,640,7512860
1105,44,44,7519973,7520689,733,7518242,7519034,932,7519966
1106,10,10,7526600,7526749,166,7525051,7525848,747,7526595
1107,14,14,7533492,7533709,233,7531877,7532662,814,7533476
1108,58,58,7540201,7541150,966,7538686,7539476,723,7540199
1109,18,18,7546911,7547194,300,7545496,7546290,604,7546894
1110,22,22,7553937,7554286,366,7552305,7553104,817,7553921
1111,6,6,7560529,7560613,100,7559131,7559918,593,7560511
1112,26,26,7567555,7567971,433,7565940,7566732,813,7567545
1113,16,16,7574398,7574647,266,7572750,7573546,842,7574388
1114,28,28,7581007,7581457,466,7579575,7580360,640,7581000
1115,58,58,7588066,7589015,966,7586385,7587174,890,7588064
1116,10,10,7594842,7594992,167,7593194,7593988,842,7594830
1117,60,60,7601568,7602551,999,7600003,7600802,762,7601564
1118,28,28,7608428,7608877,466,7606829,7607616,807,7608423
1119,14,14,7615154,7615370,233,7613639,7614430,705,7615135
1120,26,26,7622229,7622645,433,7620448,7621244,977,7622221
1121,44,44,7628889,7629605,732,7627274,7628058,828,7628886
1122,24,24,7635482,7635864,399,7634083,7634872,598,7635470
1123,52,52,7642657,7643506,866,7640892,7641686,969,7642655
1124,54,54,7649300,7650182,899,7647702,7648500,792,7649292
1125,56,56,7656126,7657041,932,7654528,7655314,797,7656111
1126,56,56,7663135,7664051,932,7661337,7662128,998,7663126
1127,42,42,7669578,7670260,699,7668146,7668942,627,7669569
1128,46,46,7676420,7677170,766,7674972,7675756,657,7676413
1129,46,46,7683280,7684029,766,7681781,7682570,697,7683267
1130,42,42,7690006,7690688,699,7688591,7689384,619,7690003
1131,26,26,7696798,7697215,433,7695400,7696198,593,7696791
1132,48,48,7703807,7704590,800,7702226,7703012,780,7703792
1133,20,20,7710417,7710733,333,7709035,7709826,578,7710404
1134,56,56,7717493,7718408,932,7715844,7716640,845,7717485
1135,32,32,7724285,7724801,533,7722670,7723454,819,7724273
1136,52,52,7731211,7732060,866,7729480,7730268,926,7731194
1137,32,32,7737687,7738204,533,7736289,7737082,601,7737683
1138,52,52,7744463,7745312,866,7743098,7743896,552,7744448
1139,48,48,7751356,7752138,799,7749924,7750710,642,7751352
1140,36,36,7758165,7758748,600,7756733,7757524,636,7758160
1141,36,36,7764958,7765541,599,7763543,7764338,614,7764952
1142,24,24,7771934,7772317,399,7770369,7771152,770,7771922
1143,10,10,7777877,7778027,167,7777178,7777183,689,7777872
1144,18,18,7784686,7784969,300,7783205,7783997,674,7784671
1145,34,34,7791596,7792145,566,7790014,7790811,769,7791580
1146,48,48,7798372,7799154,799,7796840,7797625,741,7798366
1147,38,38,7805048,7805664,632,7803649,7804439,594,7805033
1148,20,20,7811774,7812090,333,7810459,7811253,510,7811763
1149,24,24,7818966,7819349,400,7817284,7818067,882,7818949
1150,60,60,7825642,7826624,999,7824094,7824881,755,7825636
1151,2,2,7832285,7832302,33,7830903,7831695,580,7832275
1152,36,36,7839144,7839727,599,7837712,7838509,619,7839128
1153,30,30,7846053,7846536,500,7844538,7845323,712,7846035
1154,52,52,7852863,7853712,865,7851348,7852137,721,7852858
1155,58,58,7859905,7860854,966,7858157,7858951,938,7859889
1156,10,10,7866431,7866581,167,7864966,7865765,652,7866417
1157,40,40,7873274,7873923,666,7871792,7872579,679,7873258
1158,54,54,7880133,7881015,899,7878601,7879393,734,7880127
1159,14,14,7886743,7886959,233,7885411,7886207,517,7886724
1160,44,44,7893901,7894617,733,7892237,7893021,871,7893892
1161,2,2,7900444,7900461,34,7899046,7899835,593,7900428
1162,54,54,7907603,7908486,899,7905855,7906649,951,7907600
1163,16,16,7914163,7914413,266,7912664,7913463,688,7914151
1164,12,12,7921072,7921255,200,7919490,7920277,778,7921055
1165,22,22,7927998,7928347,366,7926300,7927091,900,7927991
1166,4,4,7934524,7934574,67,7933109,7933905,604,7934509
1167,56,56,7941616,7942532,933,7939935,7940719,887,7941606
1168,32,32,7948409,7948925,533,7946744,7947533,872,7948405
1169,8,8,7955335,7955451,133,7953553,7954347,971,7955318
1170,18,18,7961928,7962211,299,7960363,7961161,754,7961915
1171,10,10,7968654,7968804,166,7967189,7967975,672,7968647
1172,24,24,7975580,7975962,399,7973998,7974789,776,7975565
1173,2,2,7982139,7982156,33,7980807,7981603,533,7982136
1174,8,8,7989415,7989531,133,7987633,7988417,984,7989401
1175,46,46,7995908,7996657,765,7994442,7995231,674,7995905
1176,14,14,8002684,8002900,233,8001252,8002045,631,8002676
1177,26,26,8009426,8009842,433,8008061,8008859,552,8009411
1178,32,32,8016285,8016802,533,8014887,8015673,598,8016271
1179,36,36,8023028,8023611,599,8021696,8022487,538,8023025
1180,2,2,8030154,8030170,33,8028506,8029301,836,8030137
1181,48,48,8037046,8037829,799,8035331,8036115,923,8037038
1182,2,2,8043556,8043573,33,8042141,8042929,621,8043550
1183,6,6,8050698,8050781,100,8048950,8049743,948,8050691
1184,14,14,8057158,8057374,233,8055759,8056557,597,8057154
1185,14,14,8064283,8064500,233,8062585,8063371,908,8064279
1186,46,46,8070910,8071659,765,8069395,8070185,710,8070895
1187,30,30,8077819,8078302,499,8076204,8076999,808,8077807
1188,14,14,8084412,8084628,233,8083030,8083813,595,8084408
1189,30,30,8091437,8091920,500,8089839,8090627,800,8091427
1190,6,6,8098263,8098346,100,8096648,8097441,814,8098255
1191,42,42,8105122,8105805,700,8103458,8104255,854,8105109
1192,10,10,8111765,8111915,167,8110284,8111069,691,8111760
1193,38,38,8118841,8119457,633,8117093,8117883,951,8118834
1194,48,48,8125417,8126200,799,8123902,8124697,712,8125409
1195,30,30,8132509,8132992,500,8130728,8131511,988,8132499
1196,12,12,8139186,8139369,199,8137537,8138325,842,8139167
1197,50,50,8146078,8146894,833,8144347,8145139,936,8146075
1198,16,16,8152738,8152987,266,8151156,8151953,767,8152720
1199,50,50,8159613,8160429,833,8157982,8158767,840,8159607
1200,60,60,8165424,8166406,999,8164791,8164798,608,8165406
1201,50,50,8172233,8173049,833,8170818,8171612,609,8172221
1202,24,24,8179126,8179508,399,8177627,8178426,690,8179116
1203,42,42,8185918,8186601,699,8184453,8185240,667,8185907
1204,42,42,8192611,8193294,699,8191262,8192054,554,8192608
1205,24,24,8199670,8200053,400,8198072,8198868,789,8199657
1206,50,50,8206579,8207395,833,8204898,8205682,894,8206576
1207,46,46,8213422,8214171,766,8211707,8212496,920,8213416
1208,60,60,8219981,8220964,999,8218516,8219310,669,8219979
1209,30,30,8226841,8227323,499,8225326,8226124,700,8226824
1210,56,56,8233800,8234715,932,8232151,8232938,858,8233796
1211,6,6,8240459,8240542,100,8238961,8239752,694,8240446
1212,50,50,8247501,8248317,833,8245770,8246566,926,8247492
1213,14,14,8254361,8254577,233,8252596,8253380,974,8254354
1214,46,46,8261087,8261836,766,8259405,8260194,889,8261083
1215,42,42,8267613,8268296,699,8266215,8267008,588,8267596
1216,50,50,8274822,8275638,832,8273024,8273822,992,8274814
1217,18,18,8281198,8281481,300,8279850,8280636,544,8281180
1218,32,32,8288141,8288657,533,8286659,8287450,673,8288123
1219,46,46,8294917,8295666,766,8293468,8294264,639,8294903
1220,26,26,8302042,8302459,433,8300294,8301078,950,8302028
1221,8,8,8308619,8308735,133,8307104,8307892,721,8308613
1222,28,28,8315561,8316011,466,8313913,8314706,847,8315553
1223,36,36,8322354,8322936,599,8320722,8321520,828,8322348
1224,56,56,8328897,8329812,932,8327548,8328334,560,8328894
1225,54,54,8335789,8336671,899,8334357,8335148,631,8335779
1226,46,46,8342865,8343614,766,8341167,8341962,894,8342856
1227,56,56,8349674,8350590,932,8347993,8348776,886,8349662
1228,34,34,8356567,8357116,566,8354802,8355590,974,8356564
1229,46,46,8363043,8363792,766,8361611,8362404,626,8363030
1230,48,48,8369952,8370735,799,8368420,8369218,724,8369942
1231,40,40,8376645,8377294,666,8375246,8376032,602,8376634
1232,26,26,8383787,8384203,433,8382056,8382846,928,8383774
1233,16,16,8390530,8390779,266,8388865,8389660,852,8390512
1234,52,52,8397056,8397905,866,8395691,8396474,564,8397038
1235,20,20,8403832,8404148,333,8402500,8403288,528,8403816
1236,26,26,8410858,8411274,433,8409309,8410102,741,8410843
1237,8,8,8417917,8418033,133,8416119,8416916,998,8417914
1238,18,18,8424576,8424859,300,8422945,8423730,834,8424564
1239,10,10,8431385,8431535,167,8429754,8430544,838,8431382
1240,22,22,8438128,8438478,366,8436563,8437358,755,8438113
1241,60,60,8445137,8446120,999,8443389,8444172,950,8445122
1242,52,52,8451630,8452479,866,8450198,8450986,637,8451623
1243,32,32,8458606,8459122,533,8457008,8457800,793,8458593
1244,12,12,8465432,8465615,200,8463817,8464614,814,8465428
1245,10,10,8472225,8472374,166,8470643,8471428,794,8472222
1246,12,12,8479150,8479334,200,8477452,8478242,906,8479148
1247,4,4,8486060,8486109,66,8484261,8485056,992,8486048
1248,24,24,8492519,8492902,400,8491087,8491870,647,8492517
1249,54,54,8498779,8499661,899,8497897,8497901,869,8498770
1250,6,6,8505505,8505588,100,8503924,8504715,772,8505487
1251,32,32,8512264,8512781,533,8510733,8511529,726,8512255
1252,58,58,8519323,8520272,966,8517559,8518343,972,8519315
1253,14,14,8525816,8526033,234,8524368,8525157,645,8525802
1254,50,50,8532942,8533758,833,8531177,8531971,967,8532938
1255,12,12,8539385,8539568,200,8537987,8538785,598,8539383
1256,36,36,8546161,8546744,599,8544813,8545599,549,8546148
1257,8,8,8552987,8553104,133,8551622,8552413,572,8552985
1258,22,22,8560213,8560562,366,8558431,8559227,977,8560204
1259,30,30,8566639,8567122,499,8565257,8566041,588,8566629
1260,58,58,8573548,8574497,966,8572066,8572855,690,8573545
1261,26,26,8580291,8580707,433,8578876,8579669,619,8580288
1262,34,34,8587083,8587633,566,8585685,8586483,589,8587072
1263,6,6,8594176,8594259,100,8592511,8593297,875,8594172
1264,40,40,8600968,8601618,666,8599320,8600111,848,8600959
1265,44,44,8607528,8608244,732,8606129,8606925,597,8607522
1266,52,52,8614687,8615536,866,8612955,8613739,945,8614684
1267,42,42,8621463,8622145,699,8619765,8620553,905,8621458
1268,44,44,8628305,8629021,733,8626574,8627367,928,8628295
1269,34,34,8635165,8635714,566,8633383,8634181,973,8635154
1270,54,54,8641957,8642840,899,8640209,8640995,955,8641950
1271,32,32,8647818,8648334,532,8647018,8647026,775,8647801
1272,32,32,8654727,8655243,532,8653045,8653840,874,8654714
1273,4,4,8661603,8661653,66,8659871,8660654,944,8661598
1274,46,46,8668412,8669161,766,8666680,8667468,936,8668404
1275,20,20,8674938,8675254,333,8673490,8674282,644,8674926
1276,44,44,8681731,8682447,732,8680299,8681096,625,8681721
1277,34,34,8688657,8689206,566,8687125,8687910,730,8688640
1278,60,60,8695349,8696332,999,8693934,8694724,623,8695347
1279,20,20,8702159,8702475,333,8700744,8701538,617,8702155
1280,48,48,8709334,8710117,799,8707569,8708352,968,8709320
1281,24,24,8715827,8716210,400,8714379,8715166,659,8715825
1282,32,32,8722670,8723186,533,8721188,8721980,681,8722661
1283,54,54,8729779,8730661,899,8727997,8728794,969,8729763
1284,30,30,8736488,8736971,500,8734823,8735608,873,8736481
1285,22,22,8742931,8743281,366,8741633,8742422,502,8742924
1286,20,20,8750173,8750490,333,8748442,8749236,935,8750171
1287,38,38,8756966,8757582,633,8755251,8756050,910,8756960
1288,38,38,8763709,8764325,632,8762077,8762864,841,8763705
1289,60,60,8770634,8771617,999,8768886,8769678,954,8770632
1290,32,32,8777077,8777594,533,8775696,8776492,568,8777060
1291,2,2,8784220,8784236,33,8782522,8783306,909,8784215
1292,10,10,8791012,8791162,167,8789331,8790120,888,8791008
1293,14,14,8797638,8797855,234,8796140,8796934,690,8797624
1294,18,18,8804331,8804614,300,8802949,8803748,576,8804324
1295,4,4,8811357,8811407,67,8809775,8810562,780,8811342
1296,60,60,8818349,8819332,999,8816585,8817376,961,8818337
1297,20,20,8824776,8825092,333,8823394,8824190,580,8824770
1298,50,50,8831685,8832501,832,8830220,8831004,670,8831674
1299,6,6,8838627,8838711,100,8837029,8837818,803,8838621
1300,8,8,8845437,8845553,133,8843838,8844632,797,8845429
1301,44,44,8852246,8852962,733,8850648,8851446,792,8852238
1302,10,10,8858922,8859072,167,8857474,8858260,645,8858905
1303,22,22,8865998,8866347,366,8864283,8865074,911,8865985
1304,10,10,8872407,8872557,167,8871092,8871888,508,8872396
1305,30,30,8879466,8879949,500,8877918,8878702,754,8879456
1306,40,40,8886326,8886975,666,8884727,8885516,807,8886323
1307,34,34,8892919,8893468,566,8891537,8892330,572,8892902
1308,54,54,8899961,8900843,899,8898346,8899144,806,8899950
1309,30,30,8906870,8907353,500,8905172,8905958,900,8906858
1310,34,34,8913696,8914245,566,8911981,8912772,914,8913686
1311,60,60,8920206,8921188,999,8918790,8919586,602,8920188
1312,20,20,8927032,8927348,333,8925616,8926400,613,8927013
1313,24,24,8934157,8934540,400,8932426,8933214,934,8934148
1314,34,34,8940667,8941216,566,8939235,8940028,631,8940659
1315,20,20,8947659,8947976,333,8946044,8946842,815,8947657
1316,24,24,8954452,8954835,399,8952870,8953656,779,8954435
1317,26,26,8961344,8961761,433,8959680,8960470,856,8961326
1318,44,44,8968154,8968870,732,8966489,8967284,854,8968138
1319,58,58,8975063,8976012,965,8973315,8974098,953,8975051
1320,24,24,8981739,8982122,400,8980124,8980912,818,8981730
1321,4,4,8988482,8988532,66,8986933,8987726,749,8988475
1322,16,16,8995357,8995607,267,8993743,8994540,812,8995352
1323,58,58,9001934,9002883,965,9000569,9001354,571,9001925
1324,48,48,9008909,9009692,800,9007378,9008168,728,9008896
1325,58,58,9015702,9016651,966,9014187,9014982,715,9015697
1326,50,50,9022794,9023610,833,9021013,9021796,980,9022776
1327,54,54,9029537,9030419,899,9027822,9028610,909,9029519
1328,18,18,9036197,9036480,299,9034632,9035424,755,9036179
1329,26,26,9043072,9043489,433,9041441,9042238,819,9043057
1330,56,56,9049699,9050614,932,9048267,9049052,629,9049681
1331,6,6,9056841,9056924,100,9055076,9055866,957,9056823
1332,8,8,9063217,9063334,133,9061885,9062680,534,9063214
1333,54,54,9070210,9071092,899,9068711,9069494,700,9070194
1334,52,52,9077052,9077901,866,9075521,9076308,741,9077049
1335,24,24,9084078,9084461,400,9082330,9083122,940,9084062
1336,40,40,9090821,9091470,666,9089139,9089936,867,9090803
1337,46,46,9097547,9098296,766,9095965,9096750,780,9097530
1338,48,48,9104572,9105355,800,9102774,9103564,998,9104562
1339,10,10,9111215,9111365,167,9109584,9110378,833,9111211
1340,54,54,9118158,9119040,899,9116393,9117192,954,9118146
1341,42,42,9124784,9125466,699,9123219,9124006,769,9124775
1342,32,32,9131460,9131976,533,9130028,9130820,623,9131443
1343,28,28,9138253,9138702,466,9136837,9137634,610,9138244
1344,8,8,9145328,9145445,133,9143663,9144448,867,9145315
1345,8,8,9152154,9152271,133,9150473,9151262,889,9152151
1346,34,34,9158631,9159180,566,9157282,9158076,543,9158619
1347,14,14,9165407,9165623,233,9164091,9164890,509,9165399
1348,40,40,9172565,9173215,666,9170917,9171704,848,9172552
1349,2,2,9179175,9179192,33,9177726,9178518,649,9179167
1350,44,44,9185868,9186584,732,9184536,9185332,527,9185859
1351,44,44,9192694,9193409,732,9191362,9192146,533,9192679
1352,38,38,9199819,9200435,633,9198171,9198960,851,9199811
1353,40,40,9206495,9207145,666,9204980,9205774,706,9206480
1354,18,18,9213255,9213538,299,9211790,9212588,655,9213243
1355,52,52,9219997,9220846,866,9218615,9219402,586,9219988
1356,60,60,9227123,9228105,999,9225425,9226216,893,9227109
1357,18,18,9233982,9234265,300,9232234,9233030,945,9233975
1358,54,54,9240708,9241591,899,9239060,9239844,854,9240698
1359,52,52,9247201,9248050,866,9245869,9246658,536,9247194
1360,28,28,9254327,9254776,466,9252679,9253472,850,9254322
1361,2,2,9261103,9261119,33,9259488,9260286,812,9261098
1362,18,18,9267929,9268212,299,9266314,9267100,820,9267920
1363,50,50,9274888,9275704,832,9273123,9273914,957,9274871
1364,38,38,9281664,9282280,632,9279932,9280728,924,9281652
1365,2,2,9288373,9288390,34,9286758,9287542,814,9288356
1366,10,10,9295166,9295316,166,9293568,9294356,806,9295162
1367,2,2,9302108,9302125,34,9300377,9301170,926,9302096
1368,32,32,9308568,9309084,533,9307186,9307984,580,9308564
1369,56,56,9315510,9316426,933,9314012,9314798,701,9315499
1370,22,22,9322536,9322886,366,9320821,9321612,915,9322527
1371,20,20,9329012,9329329,333,9327631,9328426,583,9329009
1372,40,40,9335855,9336504,666,9334457,9335240,603,9335843
1373,48,48,9342897,9343680,800,9341266,9342054,825,9342879
1374,48,48,9349807,9350589,799,9348075,9348868,925,9349793
1375,16,16,9356416,9356666,267,9354884,9355682,717,9356399
1376,26,26,9363159,9363575,433,9361710,9362496,651,9363147
1377,42,42,9369852,9370534,699,9368520,9369310,533,9369843
1378,6,6,9376794,9376877,100,9375329,9376124,652,9376776
1379,38,38,9383653,9384269,633,9382155,9382938,707,9383645
1380,18,18,9390546,9390829,299,9388964,9389752,776,9390528
1381,50,50,9397355,9398171,833,9395773,9396566,787,9397353
1382,46,46,9404114,9404864,766,9402583,9403380,716,9404096
1383,58,58,9410857,9411806,966,9409409,9410194,659,9410853
1384,30,30,9417949,9418432,500,9416218,9417008,938,9417946
1385,36,36,9424659,9425242,599,9423027,9423822,826,9424648
1386,36,36,9431252,9431834,599,9429853,9430636,604,9431240
1387,38,38,9438244,9438860,633,9436662,9437450,789,9438239
1388,50,50,9444870,9445686,833,9443472,9444264,599,9444863
1389,52,52,9452013,9452862,865,9450281,9451078,919,9451997
1390,8,8,9458572,9458689,133,9457107,9457892,666,9458558
1391,14,14,9465564,9465781,234,9463916,9464706,841,9465547
1392,14,14,9472191,9472407,233,9470726,9471520,662,9472182
1393,14,14,9479200,9479416,233,9477551,9478334,856,9479190
1394,50,50,9486059,9486875,832,9484361,9485148,901,9486049
1395,30,30,9492902,9493384,499,9491170,9491962,933,9492895
1396,34,34,9499727,9500277,567,9497979,9498776,937,9499713
1397,34,34,9506254,9506803,566,9504805,9505590,654,9506244
1398,32,32,9512980,9513496,533,9511615,9512404,572,9512976
1399,28,28,9519922,9520372,466,9518424,9519218,687,9519905
1400,36,36,9526715,9527298,599,9525233,9526032,674,9526706
1401,36,36,9533574,9534157,599,9532059,9532846,710,9533556
1402,38,38,9540517,9541133,632,9538868,9539660,848,9540508
1403,60,60,9547176,9548158,999,9545678,9546474,691,9547165
1404,50,50,9553902,9554718,833,9552504,9553288,600,9553888
1405,44,44,9560911,9561627,733,9559313,9560102,807,9560909
1406,8,8,9567837,9567953,133,9566122,9566916,917,9567833
1407,24,24,9574446,9574829,400,9572931,9573730,700,9574430
1408,4,4,9581189,9581239,67,9579757,9580544,640,9581184
1409,24,24,9588248,9588631,400,9586567,9587358,886,9588244
1410,24,24,9594991,9595374,399,9593376,9594172,813,9594985
1411,60,60,9601967,9602949,999,9600202,9600986,976,9601962
1412,4,4,9608593,9608643,66,9607011,9607800,785,9608585
1413,10,10,9615402,9615552,167,9613820,9614614,776,9615390
1414,60,60,9622095,9623077,999,9620630,9621428,662,9622090
1415,22,22,9629137,9629487,366,9627456,9628242,888,9629130
1416,50,50,9636013,9636829,833,9634265,9635056,939,9635995
1417,2,2,9642789,9642806,33,9641074,9641870,908,9642778
1418,14,14,9649315,9649532,233,9647900,9648684,629,9649313
1419,60,60,9656041,9657024,999,9654709,9655498,527,9656025
1420,54,54,9663184,9664066,899,9661519,9662312,865,9663177
1421,4,4,9669776,9669826,67,9668328,9669126,642,9669768
1422,10,10,9676835,9676985,167,9675154,9675940,881,9676821
1423,24,24,9683478,9683861,400,9681963,9682754,720,9683474
1424,60,60,9690288,9691270,998,9688773,9689568,709,9690277
1425,50,50,9697080,9697896,833,9695598,9696382,688,9697070
1426,48,48,9703956,9704739,799,9702408,9703196,755,9703951
1427,44,44,9710532,9711248,733,9709217,9710010,509,9710519
1428,36,36,9717458,9718041,599,9716026,9716824,620,9717444
1429,10,10,9724284,9724434,167,9722852,9723638,634,9724272
1430,22,22,9731293,9731643,366,9729662,9730452,824,9731276
1431,34,34,9737919,9738469,566,9736471,9737266,636,9737902
1432,10,10,9745078,9745228,167,9743297,9744080,993,9745073
1433,18,18,9751871,9752154,299,9750106,9750894,963,9751857
1434,10,10,9758647,9758797,166,9756915,9757708,934,9758642
1435,16,16,9765173,9765423,266,9763725,9764522,636,9765158
1436,4,4,9772049,9772099,67,9770551,9771336,704,9772040
1437,14,14,9779141,9779358,233,9777360,9778150,977,9779127
1438,36,36,9785917,9786500,600,9784169,9784964,951,9785915
1439,54,54,9792627,9793509,899,9790995,9791778,841,9792619
1440,46,46,9799269,9800019,766,9797804,9798592,662,9799254
1441,22,22,9806229,9806578,366,9804614,9805406,812,9806218
1442,2,2,9812921,9812938,34,9811423,9812220,692,9812912
1443,10,10,9819664,9819814,166,9818249,9819034,625,9819659
1444,32,32,9826590,9827106,533,9825058,9825848,724,9826572
1445,42,42,9833249,9833932,700,9831867,9832662,583,9833245
1446,30,30,9840175,9840658,500,9838693,9839476,696,9840172
1447,56,56,9847151,9848067,932,9845503,9846290,856,9847146
1448,52,52,9854060,9854909,866,9852312,9853104,950,9854054
1449,26,26,9860536,9860953,433,9859121,9859918,615,9860533
1450,20,20,9867495,9867812,333,9865947,9866732,760,9867492
1451,60,60,9874188,9875170,999,9872756,9873546,636,9874182
1452,44,44,9880165,9880881,733,9879566,9879577,570,9880147
1453,8,8,9887257,9887374,134,9885593,9886391,858,9887249
1454,38,38,9894217,9894833,632,9892418,9893205,993,9894198
1455,28,28,9900709,9901159,467,9899228,9900019,685,9900704
1456,42,42,9907502,9908185,699,9906037,9906833,661,9907494
1457,12,12,9914495,9914678,199,9912863,9913647,838,9914485
1458,56,56,9921354,9922269,932,9919672,9920461,875,9921336
1459,60,60,9928180,9929162,999,9926482,9927275,898,9928173
1460,22,22,9935056,9935405,366,9933291,9934089,956,9935045
1461,56,56,9941765,9942681,932,9940117,9940903,851,9941754
1462,2,2,9948657,9948674,34,9946926,9947717,926,9948643
1463,44,44,9955300,9956016,733,9953735,9954531,762,9955293
1464,22,22,9962060,9962409,366,9960561,9961345,703,9962048
1465,10,10,9969085,9969235,167,9967371,9968159,924,9969083
1466,22,22,9975678,9976028,366,9974180,9974973,702,9975675
1467,46,46,9982754,9983503,766,9980989,9981787,959,9982746
1468,48,48,9989230,9990013,799,9987815,9988601,612,9989213
1469,46,46,9996389,9997138,766,9994624,9995415,969,9996384
1470,14,14,10003198,10003415,233,10001434,10002229,962,10003191
1471,42,42,10009591,10010274,700,10008260,10009043,542,10009585
1472,16,16,10016700,10016950,267,10015069,10015857,834,10016691
1473,24,24,10023626,10024009,400,10021878,10022671,946,10023617
1474,60,60,10030019,10031002,999,10028687,10029485,522,10030007
1475,8,8,10036912,10037028,133,10035513,10036299,600,10036899
1476,60,60,10042989,10043971,999,10042323,10042330,656,10042986
1477,42,42,10049798,10050480,699,10048349,10049144,650,10049794
1478,32,32,10056491,10057007,532,10055175,10055958,517,10056475
1479,20,20,10063733,10064049,333,10061985,10062772,945,10063717
1480,44,44,10070509,10071225,732,10068794,10069586,905,10070491
1481,12,12,10077185,10077368,200,10075603,10076400,782,10077182
1482,26,26,10083828,10084244,433,10082429,10083214,602,10083816
1483,44,44,10090820,10091536,733,10089238,10090028,777,10090805
1484,44,44,10097679,10098395,733,10096048,10096842,834,10097676
1485,22,22,10103656,10104006,366,10102857,10102873,779,10103652
1486,30,30,10110482,10110965,500,10108900,10109687,781,10110468
1487,20,20,10117358,10117674,333,10115710,10116501,848,10117349
1488,44,44,10124001,10124717,732,10122519,10123315,680,10123995
1489,22,22,10130760,10131110,366,10129345,10130129,621,10130750
1490,32,32,10137686,10138202,533,10136154,10136943,725,10137668
1491,14,14,10144362,10144578,233,10142964,10143757,598,10144355
1492,6,6,10151321,10151404,100,10149773,10150571,744,10151315
1493,32,32,10158180,10158696,533,10156599,10157385,788,10158173
1494,26,26,10164973,10165389,433,10163408,10164199,766,10164965
1495,44,44,10171533,10172248,732,10170217,10171013,501,10171514
1496,28,28,10178808,10179258,466,10177043,10177827,976,10178803
1497,56,56,10185451,10186366,932,10183853,10184641,803,10185444
1498,16,16,10192377,10192626,266,10190662,10191455,912,10192367
1499,60,60,10198886,10199869,999,10197471,10198269,612,10198881
1500,48,48,10205979,10206761,799,10204297,10205083,893,10205976
1501,54,54,10212788,10213670,899,10211106,10211897,879,10212776
1502,36,36,10219431,10220013,599,10217916,10218711,709,10219420
1503,56,56,10226307,10227222,932,10224742,10225525,775,10226300
1504,6,6,10233149,10233232,100,10231551,10232339,804,10233143
1505,46,46,10240142,10240891,765,10238360,10239153,974,10240127
1506,32,32,10246701,10247217,533,10245169,10245967,717,10246684
1507,4,4,10253494,10253544,66,10251995,10252781,696,10253477
1508,10,10,10260170,10260320,166,10258805,10259595,572,10260167
1509,2,2,10267262,10267279,33,10265614,10266409,837,10267246
1510,18,18,10274188,10274471,300,10272440,10273223,949,10274172
1511,6,6,10280947,10281031,100,10279249,10280037,898,10280935
1512,28,28,10287424,10287873,466,10286058,10286851,558,10287409
1513,2,2,10294649,10294666,33,10292868,10293665,967,10294632
1514,30,30,10301059,10301542,499,10299694,10300479,573,10301052
1515,46,46,10307918,10308667,766,10306503,10307293,621,10307914
1516,30,30,10314861,10315343,499,10313312,10314107,748,10314855
1517,30,30,10321470,10321953,500,10320138,10320921,531,10321452
1518,52,52,10328729,10329578,866,10326947,10327735,985,10328720
1519,26,26,10335139,10335555,432,10333757,10334549,579,10335128
1520,38,38,10342314,10342930,633,10340566,10341363,945,10342308
1521,14,14,10349107,10349323,233,10347392,10348177,919,10349096
1522,30,30,10355833,10356316,499,10354201,10354991,830,10355821
1523,50,50,10362359,10363175,833,10361011,10361805,538,10362343
1524,10,10,10369568,10369718,166,10367836,10368619,942,10369561
1525,38,38,10376361,10376977,632,10374646,10375433,915,10376348
1526,10,10,10382820,10382970,167,10381455,10382247,558,10382805
1527,38,38,10389979,10390595,633,10388264,10389061,912,10389973
1528,18,18,10396755,10397038,300,10395090,10395875,870,10396745
1529,28,28,10403348,10403797,466,10401900,10402689,654,10403343
1530,24,24,10410490,10410873,400,10408709,10409503,984,10410487
1531,6,6,10417050,10417133,100,10415518,10416317,721,10417038
1532,44,44,10424109,10424825,732,10422344,10423131,966,10424097
1533,56,56,10430485,10431401,933,10429153,10429945,522,10430467
1534,4,4,10437378,10437428,66,10435963,10436759,601,10437360
1535,14,14,10444154,10444370,233,10442789,10443573,566,10444139
1536,18,18,10451030,10451313,299,10449598,10450387,634,10451021
1537,34,34,10457872,10458422,566,10456407,10457201,661,10457862
1538,34,34,10465014,10465564,567,10463216,10464015,981,10464996
1539,24,24,10471374,10471757,400,10470042,10470829,535,10471364
1540,16,16,10478583,10478833,266,10476852,10477643,937,10478580
1541,56,56,10485159,10486075,933,10483661,10484457,696,10485153
1542,36,36,10492002,10492585,599,10490487,10491271,727,10491998
1543,10,10,10498695,10498844,166,10497296,10498085,605,10498690
1544,8,8,10505720,10505837,134,10504105,10504899,817,10505716
1545,30,30,10512313,10512796,500,10510915,10511713,586,10512299
1546,4,4,10519206,10519256,66,10517741,10518527,663,10519190
1547,50,50,10525982,10526797,832,10524550,10525341,623,10525964
1548,18,18,10533041,10533324,299,10531359,10532155,872,10533027
1549,10,10,10539817,10539967,166,10538185,10538969,833,10539802
1550,58,58,10546360,10547309,965,10544994,10545783,563,10546346
1551,20,20,10553602,10553918,333,10551804,10552597,990,10553587
1552,18,18,10560361,10560644,300,10558613,10559411,942,10560353
1553,24,24,10566804,10567187,400,10565439,10566225,564,10566789
1554,6,6,10573780,10573863,100,10572248,10573039,731,10573770
1555,38,38,10580439,10581055,633,10579058,10579853,582,10580435
1556,20,20,10587249,10587565,333,10585883,10586667,576,10587243
1557,10,10,10594091,10594241,167,10592693,10593481,607,10594088
1558,32,32,10601300,10601816,533,10599502,10600295,990,10601285
1559,14,14,10607926,10608143,233,10606311,10607109,807,10607916
1560,44,44,10614802,10615518,733,10613137,10613923,864,10614787
1561,42,42,10621262,10621944,699,10619947,10620737,507,10621244
1562,44,44,10628454,10629170,733,10626756,10627551,885,10628436
1563,56,56,10635313,10636229,933,10633582,10634365,936,10635301
1564,30,30,10642139,10642622,500,10640391,10641179,957,10642136
1565,12,12,10648682,10648865,200,10647200,10647993,685,10648678
1566,10,10,10655691,10655841,167,10654010,10654807,869,10655676
1567,22,22,10662201,10662550,366,10660836,10661621,571,10662192
1568,12,12,10669360,10669543,199,10667645,10668435,920,10669355
1569,18,18,10676152,10676435,300,10674454,10675249,889,10676138
1570,30,30,10682728,10683211,500,10681280,10682063,660,10682723
1571,46,46,10689654,10690403,766,10688089,10688877,773,10689650
1572,8,8,10696480,10696597,133,10694899,10695691,774,10696465
1573,50,50,10703323,10704139,832,10701708,10702505,805,10703310
1574,14,14,10710232,10710448,233,10708534,10709319,909,10710228
1575,12,12,10716708,10716891,200,10715343,10716133,571,10716704
1576,44,44,10723900,10724616,733,10722152,10722947,947,10723894
1577,18,18,10730660,10730943,300,10728978,10729761,893,10730654
1578,32,32,10737120,10737636,532,10735788,10736575,541,10737116
1579,34,34,10744029,10744578,566,10742597,10743389,634,10744023
1580,50,50,10751188,10752003,832,10749406,10750203,971,10751174
1581,52,52,10757581,10758430,865,10756232,10757017,547,10757564
1582,28,28,10764723,10765172,466,10763041,10763831,881,10764712
1583,4,4,10771466,10771516,66,10769851,10770645,802,10771447
1584,52,52,10778208,10779057,866,10776660,10777459,731,10778190
1585,30,30,10785267,10785750,500,10783486,10784273,980,10785253
1586,38,38,10791943,10792559,633,10790295,10791087,848,10791935
1587,26,26,10798436,10798853,433,10797104,10797901,529,10798430
1588,26,26,10805262,10805679,433,10803930,10804715,545,10805260
1589,6,6,10812321,10812405,100,10810740,10811529,789,10812318
1590,26,26,10819097,10819514,433,10817549,10818343,750,10819093
1591,16,16,10825823,10826073,267,10824358,10825157,664,10825821
1592,20,20,10832699,10833016,333,10831184,10831971,716,10832687
1593,46,46,10839475,10840224,766,10837993,10838785,674,10839459
1594,50,50,10846285,10847100,832,10844803,10845599,669,10846268
1595,26,26,10853344,10853760,432,10851629,10852413,923,10853336
1596,32,32,10859753,10860269,533,10858438,10859227,514,10859741
1597,52,52,10867029,10867878,865,10865247,10866041,981,10867022
1598,20,20,10873572,10873888,333,10872057,10872855,702,10873557
1599,38,38,10880331,10880947,633,10878883,10879669,647,10880316
1600,30,30,10887174,10887656,499,10885692,10886483,688,10887171
1601,60,60,10894149,10895132,999,10892501,10893297,838,10894135
1602,18,18,10900942,10901225,300,10899327,10900111,818,10900929
1603,6,6,10907901,10907984,100,10906136,10906925,971,10907896
1604,4,4,10914277,10914327,67,10912946,10913739,529,10914268
1605,60,60,10921370,10922352,999,10919755,10920553,811,10921364
1606,26,26,10927963,10928379,433,10926581,10927367,591,10927958
1607,50,50,10935022,10935837,832,10933390,10934181,828,10935009
1608,36,36,10941981,10942563,599,10940199,10940995,974,10941969
1609,52,52,10948574,10949423,865,10947025,10947809,748,10948557
1610,2,2,10955450,10955466,33,10953835,10954623,811,10955434
1611,6,6,10961959,10962042,100,10960644,10961437,507,10961944
1612,32,32,10968918,10969434,533,10967453,10968251,662,10968913
1613,22,22,10975711,10976060,366,10974279,10975065,636,10975701
1614,32,32,10982820,10983336,533,10981088,10981879,933,10982812
1615,54,54,10989463,10990345,899,10987898,10988693,763,10989456
1616,30,30,10996438,10996921,500,10994724,10995507,916,10996423
1617,48,48,11003015,11003797,799,11001533,11002321,691,11003012
1618,38,38,11009674,11010290,633,11008342,11009135,536,11009671
1619,20,20,11016816,11017133,333,11015151,11015949,851,11016800
1620,28,28,11023726,11024175,466,11021977,11022763,958,11023721
1621,48,48,11030452,11031234,799,11028787,11029577,856,11030433
1622,2,2,11036945,11036961,33,11035596,11036391,548,11036939
1623,22,22,11044137,11044486,366,11042422,11043205,926,11044131
1624,28,28,11050696,11051146,466,11049231,11050019,671,11050690
1625,24,24,11057539,11057922,399,11056040,11056833,703,11057536
1626,54,54,11064381,11065264,899,11062850,11063647,718,11064365
1627,16,16,11071440,11071690,267,11069676,11070461,976,11071437
1628,8,8,11078017,11078133,133,11076485,11077275,733,11078008
1629,52,52,11084859,11085708,866,11083294,11084089,755,11084844
1630,22,22,11091519,11091868,366,11090120,11090903,606,11091509
1631,6,6,11098361,11098445,100,11096929,11097717,629,11098346
1632,22,22,11105121,11105470,366,11103739,11104531,580,11105111
1633,52,52,11112046,11112896,866,11110548,11111345,699,11112044
1634,36,36,11118772,11119355,600,11117374,11118159,610,11118769
1635,34,34,11125698,11126248,566,11124183,11124973,716,11125689
1636,2,2,11132574,11132591,33,11130993,11131787,782,11132569
1637,18,18,11139600,11139883,300,11137818,11138601,989,11139590
1638,26,26,11146276,11146692,433,11144628,11145415,857,11146272
1639,44,44,11152769,11153485,733,11151437,11152229,537,11152766
1640,58,58,11159695,11160644,965,11158246,11159043,643,11159686
1641,48,48,11166604,11167386,799,11165072,11165857,743,11166600
1642,4,4,11173313,11173363,67,11171882,11172671,634,11173305
1643,8,8,11180389,11180506,133,11178691,11179485,902,11180387
1644,22,22,11187282,11187631,366,11185500,11186299,973,11187272
1645,56,56,11193691,11194607,933,11192326,11193113,575,11193688
1646,6,6,11200867,11200950,100,11199135,11199927,923,11200850
1647,14,14,11207643,11207859,233,11205945,11206741,888,11207629
1648,16,16,11214485,11214735,267,11212771,11213555,923,11214478
1649,32,32,11221178,11221694,533,11219580,11220369,806,11221175
1650,2,2,11227954,11227971,33,11226389,11227183,760,11227943
1651,6,6,11234963,11235046,100,11233198,11233997,960,11234957
1652,12,12,11241822,11242006,200,11240024,11240811,996,11241807
1653,6,6,11248166,11248249,99,11246834,11247625,529,11248154
1654,12,12,11255175,11255358,199,11253643,11254439,719,11255158
1655,4,4,11261951,11262001,66,11260469,11261253,693,11261946
1656,36,36,11268627,11269209,599,11267278,11268067,543,11268610
1657,56,56,11275702,11276618,933,11274087,11274881,810,11275691
1658,50,50,11282661,11283477,833,11280897,11281695,962,11282657
1659,14,14,11289221,11289437,233,11287723,11288509,696,11289205
1660,46,46,11295880,11296630,766,11294532,11295323,548,11295871
1661,20,20,11302790,11303106,333,11301341,11302137,635,11302772
1662,20,20,11309732,11310048,333,11308167,11308951,779,11309730
1663,2,2,11316491,11316508,34,11314976,11315765,710,11316475
1664,48,48,11323401,11324183,799,11321786,11322579,806,11323385
1665,34,34,11330027,11330576,566,11328595,11329393,625,11330018
1666,50,50,11336919,11337735,833,11335421,11336207,695,11336902
1667,30,30,11343679,11344161,499,11342230,11343021,643,11343664
1668,26,26,11350555,11350971,432,11349040,11349835,716,11350551
1669,34,34,11357630,11358180,566,11355865,11356649,975,11357624
1670,10,10,11364173,11364323,167,11362675,11363463,704,11364167
1671,46,46,11371232,11371981,766,11369484,11370277,943,11371220
1672,46,46,11377758,11378508,766,11376293,11377091,656,11377747
1673,58,58,11384534,11385483,966,11383119,11383905,626,11384531
1674,8,8,11391543,11391660,134,11389929,11390719,810,11391529
1675,4,4,11398303,11398353,66,11396738,11397533,753,11398286
1676,12,12,11404879,11405062,200,11403564,11404347,530,11404877
1677,30,30,11411988,11412471,499,11410373,11411161,824,11411985
1678,52,52,11418914,11419763,866,11417182,11417975,932,11418907
1679,32,32,11425473,11425989,533,11423992,11424789,681,11425470
1680,28,28,11432133,11432582,466,11430818,11431603,520,11432123
1681,50,50,11439042,11439858,832,11437627,11438417,615,11439032
1682,6,6,11445951,11446034,100,11444436,11445231,715,11445946
1683,4,4,11452760,11452810,67,11451262,11452045,703,11452748
1684,24,24,11459387,11459770,399,11458071,11458859,517,11459376
1685,42,42,11466429,11467112,699,11464881,11465673,745,11466418
1686,4,4,11473172,11473222,66,11471690,11472487,668,11473155
1687,22,22,11479931,11480281,366,11478516,11479301,614,11479915
1688,60,60,11487057,11488039,999,11485325,11486115,936,11487051
1689,32,32,11493766,11494282,533,11492134,11492929,827,11493756
1690,46,46,11500459,11501208,766,11498960,11499743,698,11500441
1691,36,36,11507418,11508001,599,11505770,11506557,845,11507402
1692,24,24,11514294,11514677,399,11512579,11513371,920,11514291
1693,40,40,11520986,11521636,666,11519388,11520185,794,11520979
1694,2,2,11527629,11527646,34,11526214,11526999,619,11527618
1695,46,46,11534805,11535554,766,11533023,11533813,986,11534799
1696,16,16,11541148,11541398,266,11539833,11540627,511,11541138
1697,28,28,11548290,11548740,466,11546642,11547441,831,11548272
1698,54,54,11554800,11555682,899,11553468,11554255,528,11554783
1699,56,56,11562042,11562958,932,11560277,11561069,965,11562034
1700,14,14,11568452,11568668,233,11567087,11567883,564,11568447
1701,16,16,11575461,11575711,266,11573912,11574697,758,11575455
1702,52,52,11582270,11583119,866,11580722,11581511,747,11582258
1703,42,42,11588979,11589662,700,11587531,11588325,643,11588968
1704,4,4,11595889,11595939,66,11594340,11595139,735,11595874
1705,44,44,11602598,11603314,733,11601166,11601953,640,11602593
1706,6,6,11609324,11609407,100,11607976,11608767,554,11609321
1707,60,60,11616333,11617315,999,11614785,11615581,750,11616331
1708,38,38,11623092,11623708,633,11621611,11622395,691,11623086
1709,46,46,11630201,11630951,766,11628420,11629209,984,11630193
1710,50,50,11636545,11637360,832,11635229,11636023,511,11636534
1711,8,8,11643537,11643654,133,11642039,11642837,697,11643534
1712,42,42,11650479,11651162,700,11648865,11649651,825,11650476
1713,8,8,11657289,11657405,133,11655674,11656465,816,11657281
1714,32,32,11664065,11664581,533,11662483,11663279,771,11664050
1715,46,46,11670991,11671740,765,11669309,11670093,895,11670988
1716,36,36,11677450,11678033,600,11676118,11676907,540,11677447
1717,18,18,11684709,11684992,300,11682928,11683721,981,11684702
1718,16,16,11691452,11691701,266,11689737,11690535,913,11691448
1719,44,44,11697928,11698644,733,11696563,11697349,563,11697912
1720,40,40,11704871,11705520,665,11703372,11704163,700,11704863
1721,2,2,11711813,11711830,33,11710181,11710977,829,11711806
1722,10,10,11718306,11718456,166,11717007,11717791,511,11718302
1723,4,4,11724666,11724716,66,11723817,11723822,832,11724654
1724,14,14,11731575,11731791,233,11729843,11730636,926,11731562
1725,30,30,11738351,11738834,499,11736653,11737450,884,11738334
1726,16,16,11745110,11745360,267,11743479,11744264,838,11745102
1727,6,6,11751670,11751753,100,11750288,11751078,586,11751664
1728,42,42,11758695,11759378,700,11757097,11757892,788,11758680
1729,24,24,11765555,11765938,399,11763923,11764706,838,11765544
1730,34,34,11772264,11772814,566,11770732,11771520,733,11772253
1731,22,22,11778840,11779190,367,11777542,11778334,501,11778835
1732,12,12,11786082,11786266,200,11784351,11785148,921,11786069
1733,54,54,11792675,11793558,899,11791177,11791962,707,11792669
1734,24,24,11799401,11799784,400,11797986,11798776,610,11799386
1735,40,40,11806227,11806877,666,11804796,11805590,622,11806212
1736,6,6,11813320,11813403,100,11811621,11812404,900,11813304
1737,48,48,11819962,11820745,800,11818431,11819218,728,11819946
1738,22,22,11827038,11827388,366,11825240,11826032,992,11827024
1739,52,52,11833814,11834663,866,11832049,11832846,958,11833804
1740,40,40,11840457,11841106,666,11838875,11839660,784,11840444
1741,40,40,11847466,11848115,666,11845685,11846474,975,11847449
1742,42,42,11854225,11854908,700,11852494,11853288,935,11854223
1743,20,20,11861068,11861384,333,11859303,11860102,956,11861058
1744,10,10,11867444,11867594,167,11866129,11866916,516,11867432
1745,34,34,11874254,11874803,566,11872938,11873730,514,11874244
1746,6,6,11881063,11881146,100,11879748,11880544,513,11881057
1747,36,36,11888172,11888755,599,11886574,11887358,798,11888156
1748,36,36,11894781,11895364,600,11893383,11894172,594,11894766
1749,44,44,11901874,11902590,732,11900192,11900986,883,11901869
1750,40,40,11908450,11909099,666,11907001,11907800,636,11908436
1751,8,8,11915259,11915376,133,11913827,11914614,638,11915252
1752,34,34,11922068,11922618,566,11920637,11921428,627,11922055
1753,46,46,11929177,11929927,766,11927446,11928242,926,11929168
1754,12,12,11935720,11935903,200,11934272,11935056,651,11935707
1755,6,6,11942546,11942629,100,11941081,11941870,672,11942542
1756,2,2,11949389,11949405,33,11947890,11948684,695,11949379
1757,12,12,11956181,11956365,200,11954700,11955498,672,11956170
1758,32,32,11963240,11963757,533,11961526,11962312,912,11963224
1759,54,54,11969800,11970682,899,11968335,11969126,664,11969790
1760,10,10,11976643,11976792,166,11975144,11975940,688,11976628
1761,26,26,11983535,11983951,433,11981970,11982754,779,11983533
1762,4,4,11990095,11990145,66,11988779,11989568,523,11990091
1763,16,16,11997387,11997636,266,11995589,11996382,998,11997380
1764,28,28,12004096,12004546,466,12002398,12003196,889,12004085
1765,12,12,12010606,12010789,200,12009224,12010010,579,12010589
1766,46,46,12017498,12018247,766,12016033,12016824,668,12017492
1767,10,10,12024258,12024407,166,12022842,12023638,610,12024248
1768,30,30,12031233,12031716,500,12029668,12030452,771,12031223
1769,50,50,12038143,12038958,832,12036478,12037266,873,12038139
1770,22,22,12045002,12045351,366,12043287,12044080,910,12044990
1771,48,48,12051595,12052377,799,12050096,12050894,695,12051589
1772,46,46,12058271,12059020,766,12056922,12057708,555,12058263
1773,16,16,12065296,12065546,267,12063732,12064522,768,12065290
1774,38,38,12072056,12072672,632,12070541,12071336,711,12072047
1775,60,60,12079015,12079997,999,12077367,12078150,858,12079008
1776,42,42,12085525,12086207,699,12084176,12084964,558,12085522
1777,52,52,12092634,12093483,865,12090985,12091778,839,12092617
1778,50,50,12099476,12100292,833,12097795,12098592,882,12099474
1779,48,48,12106136,12106918,799,12104621,12105406,719,12106125
1780,12,12,12112912,12113095,199,12111430,12112220,678,12112898
1781,2,2,12119771,12119787,33,12118239,12119034,725,12119759
1782,34,34,12126796,12127346,567,12125065,12125848,935,12126783
1783,48,48,12133489,12134272,799,12131874,12132662,825,12133487
1784,36,36,12140432,12141014,599,12138684,12139476,939,12140415
1785,28,28,12147108,12147557,466,12145493,12146290,805,12147095
1786,54,54,12154100,12154983,899,12152319,12153104,981,12154085
1787,26,26,12160593,12161009,433,12159128,12159918,657,12160575
1788,8,8,12167419,12167536,133,12165937,12166732,679,12167411
1789,24,24,12174312,12174695,399,12172763,12173546,757,12174303
1790,38,38,12180888,12181504,633,12179573,12180360,517,12180877
1791,10,10,12187947,12188097,166,12186382,12187174,756,12187930
1792,6,6,12194923,12195006,100,12193191,12193988,926,12194914
1793,38,38,12201682,12202298,633,12200017,12200802,874,12201676
1794,20,20,12208291,12208608,333,12206826,12207616,663,12208279
1795,44,44,12215134,12215850,733,12213636,12214430,693,12215123
1796,26,26,12221893,12222310,433,12220462,12221244,633,12221877
1797,28,28,12228886,12229335,466,12227271,12228058,812,12228870
1798,40,40,12235579,12236228,666,12234080,12234872,698,12235570
1799,46,46,12242488,12243237,766,12240889,12241686,797,12242483
1800,58,58,12248515,12249464,965,12247715,12247717,786,12248503
1801,10,10,12255257,12255407,167,12253742,12254531,709,12255240
1802,24,24,12261967,12262350,399,12260551,12261345,612,12261957
1803,38,38,12268909,12269525,633,12267361,12268159,748,12268907
1804,42,42,12275852,12276534,699,12274187,12274973,871,12275844
1805,4,4,12282328,12282378,67,12280996,12281787,535,12282322
1806,6,6,12289304,12289387,100,12287805,12288601,697,12289298
1807,42,42,12296030,12296712,699,12294631,12295415,600,12296015
1808,12,12,12303205,12303388,200,12301441,12302229,973,12303202
1809,52,52,12309965,12310814,865,12308250,12309043,914,12309957
1810,44,44,12316824,12317540,732,12315059,12315857,950,12316807
1811,30,30,12323400,12323883,500,12321885,12322671,718,12323389
1812,36,36,12330176,12330759,599,12328694,12329485,689,12330174
1813,30,30,12337002,12337485,499,12335504,12336299,689,12336988
1814,20,20,12343645,12343961,333,12342330,12343113,524,12343637
1815,46,46,12350804,12351553,766,12349139,12349927,861,12350788
1816,38,38,12357513,12358129,633,12355948,12356741,761,12357502
1817,22,22,12364489,12364838,366,12362757,12363555,922,12364477
1818,18,18,12370915,12371198,300,12369583,12370369,534,12370903
1819,48,48,12378057,12378840,800,12376393,12377183,860,12378043
1820,2,2,12384684,12384700,33,12383202,12383997,671,12384668
1821,30,30,12391809,12392292,500,12390028,12390811,991,12391802
1822,54,54,12398236,12399118,899,12396837,12397625,592,12398217
1823,12,12,12405411,12405594,200,12403646,12404439,966,12405405
1824,14,14,12412137,12412354,233,12410456,12411253,879,12412132
1825,40,40,12418713,12419363,666,12417282,12418067,629,12418696
1826,52,52,12425706,12426555,866,12424091,12424881,810,12425691
1827,8,8,12432682,12432798,133,12430900,12431695,984,12432679
1828,26,26,12439324,12439741,433,12437726,12438509,799,12439308
1829,22,22,12446267,12446616,366,12444535,12445323,926,12446249
1830,34,34,12452860,12453409,566,12451345,12452137,713,12452850
1831,60,60,12459686,12460668,999,12458154,12458951,728,12459679
1832,38,38,12466761,12467377,633,12464980,12465765,991,12466756
1833,48,48,12473238,12474020,799,12471789,12472579,654,12473233
1834,34,34,12480014,12480563,566,12478598,12479393,614,12480007
1835,36,36,12486973,12487555,599,12485424,12486207,754,12486961
1836,48,48,12493566,12494348,799,12492234,12493021,535,12493556
1837,32,32,12500441,12500958,533,12499043,12499835,595,12500430
1838,16,16,12507500,12507750,267,12505852,12506649,848,12507497
1839,14,14,12514326,12514543,234,12512678,12513463,860,12514323
1840,32,32,12520819,12521335,533,12519487,12520277,529,12520806
1841,42,42,12527995,12528678,699,12526297,12527091,899,12527990
1842,32,32,12534604,12535121,533,12533106,12533905,691,12534596
1843,14,14,12541580,12541797,233,12539932,12540719,847,12541566
1844,34,34,12548439,12548989,567,12546741,12547533,890,12548423
1845,2,2,12555149,12555165,33,12553551,12554347,795,12555142
1846,12,12,12562075,12562258,199,12560377,12561161,897,12562058
1847,14,14,12568634,12568851,233,12567186,12567975,643,12568618
1848,18,18,12575444,12575727,299,12573995,12574789,639,12575428
1849,58,58,12582236,12583185,966,12580804,12581603,622,12582225
1850,14,14,12589412,12589628,233,12587630,12588417,983,12589400
1851,24,24,12596021,12596404,400,12594440,12595231,783,12596014
1852,52,52,12602880,12603730,866,12601249,12602045,827,12602872
1853,24,24,12609490,12609873,400,12608075,12608859,626,12609485
1854,34,34,12616249,12616799,566,12614884,12615673,573,12616246
1855,36,36,12623358,12623941,600,12621693,12622487,855,12623342
1856,32,32,12630201,12630717,533,12628503,12629301,882,12630183
1857,12,12,12636827,12637010,200,12635329,12636115,707,12636822
1858,34,34,12643470,12644019,566,12642138,12642929,523,12643452
1859,38,38,12650595,12651211,633,12648947,12649743,843,12650586
1860,60,60,12657172,12658154,999,12655773,12656557,608,12657165
1861,46,46,12663998,12664747,765,12662582,12663371,616,12663987
1862,24,24,12670757,12671140,399,12669392,12670185,560,12670745
1863,12,12,12677583,12677766,200,12676201,12676999,573,12677572
1864,30,30,12684609,12685091,499,12683027,12683813,779,12684592
1865,12,12,12691335,12691518,199,12689836,12690627,702,12691329
1866,58,58,12698260,12699209,966,12696645,12697441,808,12698249
1867,52,52,12704903,12705752,866,12703471,12704255,634,12704889
1868,30,30,12711646,12712129,499,12710281,12711069,559,12711628
1869,42,42,12718488,12719171,700,12717090,12717883,600,12718483
1870,20,20,12725264,12725581,333,12723899,12724697,562,12725259
1871,4,4,12732340,12732390,67,12730725,12731511,823,12732334
1872,30,30,12738916,12739399,500,12737534,12738325,585,12738910
1873,6,6,12745709,12745792,100,12744344,12745139,564,12745703
1874,46,46,12752901,12753650,766,12751170,12751953,938,12752891
1875,44,44,12759644,12760360,732,12757979,12758767,859,12759626
1876,26,26,12766453,12766869,433,12764788,12765581,863,12766444
1877,36,36,12773312,12773895,600,12771598,12772395,912,12773307
1878,4,4,12780172,12780222,66,12778423,12779209,954,12780163
1879,56,56,12786931,12787847,932,12785233,12786023,893,12786916
1880,38,38,12793657,12794273,633,12792042,12792837,802,12793639
1881,28,28,12800599,12801049,467,12798868,12799651,934,12800585
1882,60,60,12807342,12808324,999,12805677,12806465,860,12807325
1883,24,24,12813918,12814301,400,12812487,12813279,630,12813909
1884,58,58,12820744,12821693,966,12819296,12820093,645,12820738
1885,36,36,12827437,12828020,599,12826122,12826907,516,12827423
1886,46,46,12834413,12835162,766,12832931,12833721,681,12834402
1887,8,8,12841455,12841572,133,12839740,12840535,904,12841439
1888,52,52,12848098,12848947,866,12846566,12847349,735,12848084
1889,46,46,12855074,12855823,766,12853376,12854163,894,12855057
1890,12,12,12861667,12861850,199,12860185,12860977,671,12861648
1891,28,28,12868692,12869142,466,12866994,12867791,890,12868681
1892,12,12,12875169,12875352,199,12873820,12874605,553,12875158
1893,42,42,12882011,12882694,699,12880629,12881419,575,12881994
1894,20,20,12889137,12889453,333,12887439,12888233,901,12889134
1895,48,48,12895863,12896645,799,12894265,12895047,811,12895858
1896,54,54,12902472,12903355,899,12901074,12901861,599,12902460
1897,6,6,12909365,12909448,100,12907883,12908675,683,12909358
1898,6,6,12916141,12916224,100,12914692,12915489,638,12916127
1899,28,28,12923133,12923583,466,12921518,12922303,822,12923125
1900,34,34,12929909,12930459,566,12928328,12929117,790,12929907
1901,18,18,12936452,12936735,300,12935137,12935931,515,12936446
1902,26,26,12943643,12944060,433,12941962,12942745,893,12943638
1903,50,50,12950120,12950935,832,12948771,12949559,544,12950103
1904,42,42,12957095,12957778,700,12955580,12956373,706,12957079
1905,12,12,12964055,12964238,199,12962390,12963187,851,12964038
1906,52,52,12970564,12971413,866,12969216,12970001,550,12970551
1907,34,34,12977673,12978223,566,12976025,12976815,842,12977657
1908,30,30,12984283,12984765,499,12982834,12983629,640,12984269
1909,30,30,12991159,12991641,499,12989660,12990443,702,12991145
1910,32,32,12998018,12998534,533,12996469,12997257,748,12998005
1911,40,40,13004944,13005593,666,13003279,13004071,856,13004927
1912,20,20,13011753,13012069,333,13010088,13010885,850,13011735
1913,6,6,13018595,13018679,100,13016914,13017699,894,13018593
1914,38,38,13025371,13025987,633,13023723,13024513,852,13025365
1915,32,32,13031914,13032430,533,13030533,13031327,572,13031899
1916,10,10,13039157,13039306,166,13037358,13038141,999,13039140
1917,6,6,13045866,13045949,100,13044168,13044955,902,13045857
1918,6,6,13052692,13052775,100,13050977,13051769,914,13052683
1919,34,34,13059435,13059984,566,13057786,13058583,834,13059417
1920,54,54,13066077,13066960,899,13064612,13065397,663,13066060
1921,42,42,13073086,13073769,700,13071422,13072211,866,13073077
1922,48,48,13079763,13080545,799,13078231,13079025,729,13079754
1923,10,10,13086655,13086805,167,13085040,13085839,799,13086638
1924,38,38,13093464,13094080,633,13091866,13092653,794,13093447
1925,6,6,13100440,13100523,100,13098675,13099467,959,13100426
1926,20,20,13107000,13107316,333,13105485,13106281,708,13106989
1927,60,60,13113742,13114725,999,13112311,13113095,635,13113730
1928,60,60,13120701,13121684,999,13119120,13119909,775,13120684
1929,18,18,13127577,13127860,300,13125929,13126723,838,13127561
1930,6,6,13134303,13134387,100,13132738,13133537,761,13134298
1931,44,44,13141046,13141762,733,13139564,13140351,685,13141036
1932,2,2,13147989,13148005,33,13146374,13147165,819,13147984
1933,44,44,13154698,13155414,733,13153183,13153979,702,13154681
1934,36,36,13161690,13162273,600,13160009,13160793,884,13161677
1935,18,18,13168333,13168616,300,13166818,13167607,713,13168320
1936,32,32,13175192,13175709,533,13173627,13174421,765,13175186
1937,38,38,13181835,13182451,633,13180437,13181235,591,13181826
1938,12,12,13188794,13188977,200,13187263,13188049,737,13188786
1939,26,26,13195420,13195837,433,13194072,13194863,553,13195416
1940,20,20,13202346,13202663,333,13200881,13201677,665,13202342
1941,54,54,13209189,13210071,899,13207707,13208491,691,13209182
1942,4,4,13216048,13216098,67,13214516,13215305,737,13216042
1943,28,28,13222641,13223090,466,13221326,13222119,518,13222637
1944,34,34,13229667,13230216,566,13228135,13228933,719,13229652
1945,14,14,13236426,13236642,233,13234961,13235747,675,13236422
1946,14,14,13243285,13243502,233,13241770,13242561,712,13243273
1947,16,16,13250278,13250527,266,13248580,13249375,886,13250261
1948,46,46,13256704,13257453,766,13255405,13256189,505,13256694
1949,12,12,13263913,13264096,200,13262215,13263003,900,13263903
1950,22,22,13270339,13270689,367,13269024,13269817,506,13270323
1951,20,20,13277598,13277914,333,13275833,13276631,958,13277589
1952,14,14,13284124,13284341,233,13282659,13283445,669,13284114
1953,22,22,13291050,13291400,366,13289469,13290259,777,13291036
1954,56,56,13297943,13298858,932,13296278,13297073,858,13297931
1955,6,6,13304402,13304486,100,13303104,13303887,504,13304391
1956,40,40,13311511,13312161,666,13309913,13310701,797,13311498
1957,52,52,13318237,13319086,866,13316722,13317515,706,13318221
1958,10,10,13324947,13325097,166,13323532,13324329,611,13324940
1959,18,18,13331706,13331989,300,13330358,13331143,561,13331704
1960,30,30,13338898,13339381,500,13337167,13337957,924,13338881
1961,58,58,13345591,13346540,966,13343976,13344771,805,13345576
1962,30,30,13352550,13353033,500,13350802,13351585,957,13352542
1963,52,52,13359393,13360242,865,13357611,13358399,986,13359385
1964,52,52,13365736,13366585,866,13364421,13365213,516,13365729
1965,8,8,13372545,13372662,133,13371230,13372027,500,13372527
1966,44,44,13379521,13380237,732,13378056,13378841,665,13379506
1967,2,2,13386230,13386247,34,13384865,13385655,572,13386227
1968,46,46,13393040,13393789,765,13391674,13392469,563,13393032
1969,54,54,13399965,13400848,899,13398500,13399283,680,13399963
1970,42,42,13407041,13407724,699,13405310,13406097,934,13407031
1971,60,60,13413900,13414883,999,13412119,13412911,977,13413888
1972,60,60,13420377,13421359,999,13418928,13419725,643,13420368
1973,16,16,13427369,13427619,266,13425754,13426539,820,13427359
1974,40,40,13434212,13434861,666,13432563,13433353,845,13434198
1975,58,58,13440788,13441737,965,13439373,13440167,611,13440778
1976,46,46,13447514,13448263,766,13446182,13446981,517,13447498
1977,40,40,13454773,13455422,666,13453008,13453795,971,13454766
1978,44,44,13461349,13462065,732,13459817,13460609,733,13461342
1979,4,4,13468341,13468391,67,13466626,13467423,910,13468333
1980,48,48,13475117,13475900,799,13473452,13474237,867,13475104
1981,22,22,13481877,13482226,366,13480262,13481051,812,13481863
1982,44,44,13488769,13489485,733,13487071,13487865,901,13488766
1983,44,44,13495612,13496328,732,13493880,13494679,924,13495603
1984,50,50,13502021,13502837,833,13500706,13501493,521,13502014
1985,42,42,13509014,13509696,699,13507516,13508307,701,13509008
1986,32,32,13515723,13516239,533,13514325,13515121,587,13515708
1987,60,60,13522899,13523881,999,13521151,13521935,953,13522888
1988,8,8,13529525,13529642,133,13527960,13528749,764,13529513
1989,12,12,13536151,13536334,200,13534769,13535563,582,13536145
1990,46,46,13542927,13543676,766,13541579,13542377,535,13542912
1991,38,38,13549770,13550386,632,13548405,13549191,561,13549752
1992,24,24,13556862,13557245,400,13555214,13556005,843,13556848
1993,32,32,13563655,13564171,532,13562023,13562819,820,13563639
1994,20,20,13570597,13570913,333,13568849,13569633,956,13570589
1995,34,34,13577157,13577706,566,13575658,13576447,703,13577150
1996,34,34,13584049,13584599,566,13582468,13583261,776,13584037
1997,58,58,13590725,13591674,966,13589277,13590075,648,13590723
1998,30,30,13597501,13597984,500,13596103,13596889,594,13597483
1999,12,12,13604311,13604494,199,13602912,13603703,599,13604302
2000,48,48,13611436,13612219,799,13609721,13610517,915,13611432
2001,14,14,13618062,13618279,233,13616547,13617331,717,13618048
2002,22,22,13624805,13625155,366,13623357,13624145,650,13624795
2003,14,14,13631847,13632064,234,13630166,13630959,881,13631840
2004,58,58,13638690,13639639,966,13636975,13637773,904,13638677
2005,6,6,13645533,13645616,99,13643801,13644587,938,13645525
2006,54,54,13652125,13653008,899,13650610,13651401,708,13652109
2007,16,16,13659101,13659351,267,13657420,13658215,873,13659088
2008,6,6,13665744,13665827,100,13664246,13665029,697,13665726
2009,16,16,13672553,13672803,267,13671055,13671843,696,13672539
2010,58,58,13679296,13680245,966,13677864,13678657,631,13679288
2011,58,58,13685989,13686938,965,13684673,13685471,512,13685983
2012,50,50,13693031,13693847,833,13691499,13692285,733,13693018
2013,56,56,13699990,13700906,933,13698309,13699099,877,13699976
2014,44,44,13706633,13707349,733,13705118,13705913,708,13706621
2015,16,16,13713692,13713942,266,13711944,13712727,955,13713682
2016,38,38,13720318,13720934,633,13718753,13719541,764,13720305
2017,42,42,13727111,13727793,699,13725562,13726355,748,13727103
2018,60,60,13734020,13735002,999,13732372,13733169,833,13734002
2019,10,10,13740946,13741096,166,13739198,13739983,945,13740928
2020,12,12,13747356,13747539,199,13746007,13746797,544,13747341
2021,6,6,13754281,13754365,100,13752816,13753611,664,13754275
2022,40,40,13761240,13761890,666,13759642,13760425,809,13761234
2023,42,42,13768066,13768749,700,13766452,13767239,814,13768053
2024,34,34,13774959,13775508,566,13773261,13774053,893,13774946
2025,46,46,13781702,13782451,765,13780070,13780867,826,13781693
2026,58,58,13788361,13789310,966,13786896,13787681,667,13788348
2027,4,4,13795270,13795320,67,13793705,13794495,763,13795258
2028,54,54,13802080,13802962,899,13800515,13801309,768,13802077
2029,36,36,13808772,13809355,600,13807341,13808123,633,13808756
2030,4,4,13815665,13815715,66,13814150,13814937,713,13815650
2031,36,36,13822358,13822940,599,13820959,13821751,603,13822354
2032,24,24,13829383,13829766,400,13827768,13828565,808,13829373
2033,2,2,13836159,13836176,34,13834594,13835379,778,13836157
2034,6,6,13842869,13842952,100,13841404,13842193,662,13842855
2035,58,58,13849911,13850860,966,13848213,13849007,887,13849894
2036,38,38,13856487,13857103,633,13855022,13855821,648,13856469
2037,14,14,13863496,13863713,233,13861848,13862635,858,13863493
2038,6,6,13870106,13870189,100,13868657,13869449,645,13870094
2039,2,2,13876832,13876848,33,13875467,13876263,551,13876814
2040,42,42,13883824,13884507,700,13882293,13883077,741,13883818
2041,10,10,13890617,13890767,166,13889102,13889891,708,13890599
2042,14,14,13897476,13897693,233,13895911,13896705,754,13897459
2043,44,44,13904419,13905135,732,13902720,13903519,892,13904411
2044,8,8,13911278,13911394,133,13909546,13910333,942,13911275
2045,52,52,13918037,13918886,866,13916356,13917147,879,13918026
2046,28,28,13924946,13925396,467,13923165,13923961,971,13924932
2047,32,32,13931339,13931856,533,13929991,13930775,552,13931327
2048,14,14,13938565,13938781,233,13936800,13937589,972,13938561
2049,48,48,13945258,13946040,799,13943609,13944403,838,13945241
2050,36,36,13950952,13951534,599,13950419,13950434,507,13950941
2051,50,50,13958044,13958860,832,13956462,13957248,790,13958038
2052,60,60,13964920,13965902,999,13963271,13964062,847,13964909
2053,4,4,13971529,13971579,67,13970081,13970876,644,13971520
2054,36,36,13978688,13979271,599,13976907,13977690,990,13978680
2055,16,16,13985065,13985314,266,13983716,13984504,554,13985058
2056,58,58,13992323,13993272,966,13990525,13991318,995,13992313
2057,40,40,13998750,13999399,666,13997335,13998132,605,13998737
2058,34,34,14005526,14006075,566,14004161,14004946,562,14005508
2059,22,22,14012635,14012984,366,14010970,14011760,860,14012620
2060,2,2,14019244,14019261,33,14017779,14018574,659,14019233
2061,26,26,14026103,14026520,433,14024605,14025388,706,14026094
2062,38,38,14032996,14033612,633,14031414,14032202,790,14032992
2063,10,10,14039605,14039755,167,14038224,14039016,582,14039598
2064,34,34,14046648,14047197,566,14045033,14045830,806,14046636
2065,32,32,14053374,14053890,533,14051859,14052644,726,14053370
2066,56,56,14059983,14060899,933,14058668,14059458,521,14059979
2067,40,40,14067026,14067675,666,14065477,14066272,744,14067016
2068,48,48,14073918,14074701,799,14072303,14073086,824,14073910
2069,10,10,14080777,14080927,167,14079113,14079900,872,14080772
2070,8,8,14087653,14087770,134,14085922,14086714,935,14087649
2071,44,44,14094080,14094796,732,14092731,14093528,534,14094062
2072,12,12,14101105,14101289,200,14099557,14100342,747,14101089
2073,6,6,14108031,14108114,100,14106366,14107156,871,14108027
2074,60,60,14114957,14115939,999,14113176,14113970,975,14114945
2075,30,30,14121483,14121966,500,14120002,14120784,692,14121476
2076,10,10,14128326,14128476,166,14126811,14127598,711,14128309
2077,6,6,14135418,14135501,100,14133620,14134412,997,14135409
2078,10,10,14141928,14142078,166,14140429,14141226,696,14141922
2079,60,60,14148654,14149636,999,14147255,14148040,604,14148644
2080,16,16,14155496,14155746,267,14154065,14154854,626,14155480
2081,42,42,14162572,14163255,699,14160874,14161668,901,14162569
2082,60,60,14169132,14170114,999,14167683,14168482,640,14169122
2083,60,60,14176291,14177273,999,14174509,14175296,987,14176283
2084,20,20,14183033,14183350,333,14181318,14182110,920,14183030
2085,54,54,14189576,14190459,899,14188128,14188924,648,14189572
2086,46,46,14196336,14197085,765,14194954,14195738,580,14196318
2087,42,42,14203178,14203861,699,14201763,14202552,612,14203164
2088,8,8,14210037,14210154,134,14208572,14209366,653,14210019
2089,34,34,14217146,14217696,566,14215382,14216180,960,14217140
2090,2,2,14223589,14223606,34,14222207,14222994,589,14223583
2091,2,2,14230698,14230715,34,14229017,14229808,881,14230689
2092,56,56,14237191,14238107,933,14235826,14236622,559,14237181
2093,4,4,14243235,14243285,66,14242652,14242653,567,14243220
2094,12,12,14250260,14250444,200,14248679,14249467,784,14250251
2095,12,12,14256803,14256986,200,14255488,14256281,509,14256790
2096,48,48,14263712,14264495,800,14262297,14263095,607,14263702
2097,16,16,14270722,14270971,266,14269123,14269909,798,14270707
2098,34,34,14277381,14277930,566,14275933,14276723,649,14277372
2099,30,30,14284224,14284706,499,14282742,14283537,679,14284216
2100,12,12,14290883,14291066,200,14289568,14290351,528,14290879
2101,40,40,14297892,14298541,666,14296377,14297165,722,14297887
2102,10,10,14304851,14305001,167,14303186,14303979,862,14304841
2103,26,26,14311677,14312093,433,14309996,14310793,879,14311672
2104,34,34,14318337,14318886,566,14316822,14317607,719,14318326
2105,36,36,14324979,14325562,600,14323631,14324421,541,14324962
2106,16,16,14331805,14332055,267,14330440,14331235,559,14331794
2107,10,10,14338615,14338764,166,14337266,14338049,561,14338610
2108,16,16,14345540,14345790,267,14344075,14344863,673,14345536
2109,24,24,14352250,14352633,399,14350885,14351677,563,14352240
2110,2,2,14359042,14359059,34,14357694,14358491,540,14359031
2111,34,34,14366018,14366568,566,14364520,14365305,701,14366006
2112,6,6,14372861,14372944,100,14371329,14372119,724,14372843
2113,32,32,14379570,14380086,533,14378138,14378933,626,14379559
2114,44,44,14386679,14387395,733,14384964,14385747,917,14386664
2115,16,16,14393455,14393705,267,14391774,14392561,889,14393450
2116,54,54,14400198,14401080,899,14398583,14399375,812,14400187
2117,52,52,14406941,14407790,865,14405392,14406189,742,14406931
2118,22,22,14413900,14414249,366,14412218,14413003,892,14413895
2119,44,44,14420559,14421275,733,14419027,14419817,737,14420554
2120,28,28,14427585,14428034,466,14425837,14426631,939,14427570
2121,6,6,14434311,14434394,100,14432646,14433445,858,14434303
2122,56,56,14441104,14442019,932,14439472,14440259,833,14441092
2123,18,18,14447730,14448013,299,14446281,14447073,640,14447713
2124,50,50,14454622,14455438,833,14453091,14453887,733,14454620
2125,48,48,14461631,14462414,799,14459916,14460701,916,14461617
2126,28,28,14468507,14468957,466,14466726,14467515,984,14468499
2127,54,54,14474950,14475833,899,14473535,14474329,608,14474937
2128,14,14,14482159,14482375,233,14480344,14481143,998,14482141
2129,20,20,14488652,14488968,333,14487170,14487957,677,14488634
2130,60,60,14495495,14496477,999,14493980,14494771,706,14495477
2131,48,48,14502104,14502887,799,14500789,14501585,512,14502097
2132,26,26,14508997,14509413,432,14507615,14508399,580,14508979
2133,54,54,14515823,14516705,899,14514424,14515213,599,14515812
2134,18,18,14523031,14523314,300,14521233,14522027,986,14523013
2135,58,58,14529375,14530323,965,14528043,14528841,515,14529356
2136,2,2,14536533,14536550,34,14534869,14535655,864,14536519
2137,6,6,14543259,14543343,100,14541678,14542469,778,14543247
2138,22,22,14550152,14550502,366,14548487,14549283,852,14550135
2139,4,4,14556911,14556961,67,14555313,14556097,802,14556899
2140,8,8,14563654,14563771,133,14562122,14562911,730,14563641
2141,28,28,14570264,14570713,466,14568932,14569725,522,14570247
2142,38,38,14577256,14577872,633,14575741,14576539,714,14577253
2143,26,26,14583949,14584365,433,14582567,14583353,585,14583938
2144,22,22,14591008,14591357,366,14589376,14590167,826,14590993
2145,8,8,14597784,14597900,133,14596185,14596981,787,14597768
2146,46,46,14604493,14605242,766,14603011,14603795,689,14604484
2147,42,42,14611585,14612268,700,14609821,14610609,971,14611580
2148,56,56,14618112,14619027,932,14616630,14617423,675,14618098
2149,12,12,14625087,14625271,200,14623439,14624237,832,14625069
2150,14,14,14631747,14631963,233,14630265,14631051,689,14631740
2151,14,14,14638856,14639072,233,14637074,14637865,987,14638852
2152,28,28,14645232,14645682,466,14643884,14644679,539,14645218
2153,46,46,14652424,14653174,766,14650710,14651493,916,14652409
2154,46,46,14658867,14659617,766,14657519,14658307,544,14658851
2155,36,36,14665793,14666376,600,14664328,14665121,668,14665789
2156,34,34,14672486,14673035,566,14671138,14671935,548,14672483
2157,10,10,14679612,14679762,166,14677963,14678749,853,14679602
2158,44,44,14686421,14687137,733,14684773,14685563,854,14686417
2159,48,48,14692947,14693730,799,14691582,14692377,563,14692940
2160,60,60,14699757,14700739,998,14698408,14699191,559,14699750
2161,26,26,14706616,14707032,433,14705217,14706005,606,14706611
2162,58,58,14713675,14714624,965,14712027,14712819,851,14713670
2163,8,8,14720251,14720367,133,14718836,14719633,606,14720239
2164,50,50,14727310,14728126,832,14725662,14726447,846,14727293
2165,40,40,14734252,14734902,666,14732471,14733261,984,14734245
2166,18,18,14740912,14741195,300,14739280,14740075,819,14740894
2167,2,2,14747754,14747771,34,14746106,14746889,856,14747745
2168,4,4,14754614,14754664,66,14752916,14753703,896,14754599
2169,8,8,14761107,14761223,133,14759725,14760517,582,14761099
2170,54,54,14768032,14768915,900,14766534,14767331,698,14768029
2171,4,4,14774825,14774875,67,14773360,14774145,664,14774809
2172,28,28,14781884,14782334,466,14780169,14780959,910,14781869
2173,32,32,14788560,14789076,533,14786979,14787773,780,14788553
2174,42,42,14795186,14795869,700,14793805,14794587,581,14795168
2175,22,22,14802162,14802512,366,14800614,14801401,747,14802148
2176,58,58,14808738,14809687,966,14807423,14808215,511,14808726
2177,52,52,14815747,14816597,866,14814232,14815029,709,14815738
2178,8,8,14822823,14822940,133,14821058,14821843,970,14822813
2179,14,14,14829416,14829632,233,14827868,14828657,752,14829409
2180,22,22,14835992,14836342,366,14834677,14835471,514,14835985
2181,46,46,14843201,14843950,766,14841486,14842285,911,14843196
2182,4,4,14849661,14849711,66,14848312,14849099,559,14849658
2183,16,16,14856720,14856969,266,14855121,14855913,801,14856714
2184,60,60,14863679,14864661,999,14861931,14862727,940,14863667
2185,12,12,14870338,14870521,200,14868757,14869541,786,14870327
2186,8,8,14877114,14877231,133,14875566,14876355,745,14877100
2187,26,26,14883890,14884306,433,14882375,14883169,716,14883885
2188,6,6,14890516,14890600,100,14889185,14889983,520,14890503
2189,26,26,14897775,14898191,433,14896010,14896797,969,14897766
2190,28,28,14904152,14904601,466,14902820,14903611,529,14904140
2191,46,46,14911410,14912160,766,14909629,14910425,974,14911399
2192,6,6,14917987,14918070,100,14916455,14917239,737,14917976
2193,6,6,14924846,14924929,100,14923264,14924053,787,14924840
2194,24,24,14931422,14931805,400,14930074,14930867,546,14931413
2195,52,52,14938614,14939463,866,14936883,14937681,922,14938603
2196,44,44,14945041,14945757,732,14943709,14944495,536,14945031
2197,40,40,14952050,14952699,666,14950518,14951309,732,14952041
2198,10,10,14959009,14959159,166,14957327,14958123,871,14958994
2199,8,8,14965685,14965801,133,14964153,14964937,737,14965674
2200,8,8,14972527,14972644,134,14970963,14971751,762,14972513
2201,46,46,14979237,14979986,766,14977772,14978565,664,14979229
2202,20,20,14986163,14986479,333,14984581,14985379,778,14986157
2203,14,14,14992872,14993089,233,14991407,14992193,666,14992859
2204,4,4,14999631,14999681,67,14998216,14999007,614,14999621
2205,50,50,15006724,15007540,832,15005026,15005821,885,15006706
2206,10,10,15013200,15013350,167,15011852,15012635,555,15013190
2207,46,46,15020043,15020792,766,15018661,15019449,591,15020040
2208,4,4,15026885,15026935,67,15025470,15026263,610,15026873
2209,26,26,15033744,15034161,433,15032279,15033077,659,15033736
2210,28,28,15040737,15041186,466,15039105,15039891,839,15040730
2211,48,48,15047446,15048229,799,15045915,15046705,733,15047438
2212,12,12,15054289,15054472,200,15052724,15053519,758,15054277
2213,46,46,15060948,15061698,766,15059550,15060333,599,15060932
2214,38,38,15067974,15068590,633,15066359,15067147,811,15067958
2215,38,38,15074517,15075133,633,15073168,15073961,540,15074501
2216,10,10,15081509,15081659,167,15079978,15080775,729,15081504
2217,40,40,15088102,15088752,666,15086804,15087589,505,15088094
2218,58,58,15094978,15095927,966,15093613,15094403,562,15094965
2219,24,24,15101921,15102303,399,15100422,15101217,700,15101917
2220,28,28,15108630,15109079,466,15107248,15108031,585,15108616
2221,42,42,15115456,15116138,699,15114057,15114845,597,15115442
2222,50,50,15122348,15123164,833,15120867,15121659,672,15122331
2223,4,4,15129091,15129141,67,15127676,15128473,609,15129082
2224,42,42,15135917,15136600,699,15134502,15135287,628,15135915
2225,52,52,15143043,15143892,865,15141311,15142101,930,15143031
2226,16,16,15149469,15149719,266,15148120,15148915,548,15149463
2227,28,28,15156362,15156811,466,15154946,15155729,625,15156354
2228,8,8,15163437,15163554,133,15161756,15162543,891,15163434
2229,30,30,15169930,15170413,500,15168565,15169357,556,15169913
2230,42,42,15176789,15177472,700,15175374,15176171,607,15176778
2231,20,20,15183965,15184281,333,15182200,15182985,973,15183958
2232,46,46,15190341,15191091,766,15189010,15189799,536,15190335
2233,12,12,15197217,15197400,200,15195819,15196613,589,15197202
2234,30,30,15204010,15204493,499,15202628,15203427,566,15203993
2235,46,46,15210769,15211518,766,15209454,15210241,524,15210765
2236,20,20,15217678,15217995,333,15216263,15217055,609,15217664
2237,2,2,15224454,15224471,34,15223073,15223869,573,15224442
2238,56,56,15231314,15232229,932,15229899,15230683,616,15231299
2239,60,60,15238456,15239438,999,15236708,15237497,952,15238449
2240,12,12,15245282,15245465,200,15243517,15244311,968,15245279
2241,24,24,15251642,15252025,399,15250326,15251125,513,15251638
2242,28,28,15258850,15259300,467,15257152,15257939,894,15258833
2243,36,36,15265510,15266093,599,15263962,15264753,749,15265502
2244,58,58,15272069,15273018,966,15270771,15271567,500,15272067
2245,28,28,15278912,15279362,466,15277597,15278381,524,15278905
2246,58,58,15285838,15286787,966,15284406,15285195,628,15285823
2247,52,52,15292664,15293513,866,15291215,15292009,651,15292660
2248,60,60,15299690,15300672,998,15298025,15298823,863,15299686
2249,2,2,15306416,15306432,33,15304851,15305637,763,15306400
2250,6,6,15312958,15313042,100,15311660,15312451,503,15312954
2251,58,58,15319868,15320817,965,15318469,15319265,585,15319850
2252,42,42,15326827,15327509,699,15325295,15326079,738,15326817
2253,56,56,15333470,15334385,932,15332104,15332893,563,15333456
2254,44,44,15340612,15341328,732,15338914,15339707,898,15340605
2255,14,14,15347271,15347488,233,15345723,15346521,747,15347268
2256,52,52,15353981,15354830,865,15352549,15353335,637,15353972
2257,22,22,15361106,15361456,367,15359358,15360149,946,15361095
2258,50,50,15367682,15368498,833,15366167,15366963,705,15367668
2259,12,12,15374592,15374775,199,15372993,15373777,810,15374587
2260,40,40,15381301,15381950,666,15379803,15380591,697,15381288
2261,2,2,15387911,15387927,33,15386612,15387405,500,15387905
2262,58,58,15395219,15396168,966,15393421,15394219,986,15395205
2263,52,52,15401779,15402628,866,15400247,15401033,739,15401772
2264,28,28,15408388,15408838,467,15407056,15407847,526,15408373
2265,48,48,15415597,15416380,799,15413866,15414661,920,15415581
2266,12,12,15422490,15422673,200,15420692,15421475,997,15422472
2267,46,46,15428983,15429732,766,15427501,15428289,685,15428974
2268,46,46,15435659,15436408,766,15434310,15435103,544,15435647
2269,20,20,15442834,15443151,333,15441120,15441917,903,15442820
2270,56,56,15449261,15450176,932,15447945,15448731,527,15449258
2271,42,42,15456120,15456803,699,15454755,15455545,565,15456110
2272,4,4,15463212,15463262,67,15461564,15462359,847,15463206
2273,50,50,15469705,15470521,833,15468390,15469173,529,15469702
2274,40,40,15476581,15477230,666,15475199,15475987,592,15476579
2275,14,14,15483640,15483857,233,15482009,15482801,833,15483634
2276,44,44,15490566,15491282,733,15488818,15489615,944,15490559
2277,10,10,15497325,15497475,167,15495644,15496429,887,15497316
2278,28,28,15503802,15504251,466,15502453,15503243,540,15503783
2279,44,44,15510927,15511643,733,15509262,15510057,853,15510910
2280,60,60,15517753,15518735,999,15516088,15516871,875,15517746
2281,26,26,15524329,15524746,433,15522898,15523685,634,15524319
2282,6,6,15531272,15531355,100,15529707,15530499,767,15531266
2283,40,40,15538131,15538780,666,15536516,15537313,811,15538124
2284,60,60,15544774,15545756,999,15543342,15544127,635,15544762
2285,32,32,15551550,15552066,533,15550151,15550941,601,15551542
2286,56,56,15558492,15559408,933,15556961,15557755,733,15558488
2287,2,2,15565352,15565368,33,15563787,15564569,779,15565348
2288,2,2,15572311,15572327,33,15570596,15571383,922,15572305
2289,30,30,15579103,15579586,500,15577405,15578197,898,15579095
2290,50,50,15585963,15586778,832,15584214,15585011,949,15585960
2291,34,34,15592456,15593005,566,15591040,15591825,612,15592437
2292,20,20,15599481,15599798,333,15597850,15598639,831,15599470
2293,26,26,15606324,15606740,433,15604659,15605453,868,15606321
2294,50,50,15613216,15614032,833,15611468,15612267,942,15613209
2295,12,12,15620009,15620192,200,15618294,15619081,911,15619992
2296,52,52,15626852,15627701,865,15625103,15625895,942,15626837
2297,26,26,15633561,15633977,433,15631913,15632709,837,15633546
2298,14,14,15640204,15640420,233,15638739,15639523,666,15640189
2299,56,56,15646930,15647845,932,15645548,15646337,588,15646925
2300,2,2,15653806,15653822,33,15652357,15653151,643,15653794
2301,6,6,15660881,15660965,100,15659167,15659965,908,15660873
2302,44,44,15667341,15668057,733,15665992,15666779,558,15667337
2303,14,14,15674134,15674350,233,15672802,15673593,536,15674129
2304,22,22,15681392,15681742,367,15679611,15680407,967,15681374
2305,60,60,15687769,15688751,999,15686437,15687221,541,15687762
2306,8,8,15694845,15694961,133,15693246,15694035,796,15694831
2307,32,32,15701687,15702203,533,15700056,15700849,834,15701683
2308,22,22,15708663,15709013,366,15706865,15707663,983,15708646
2309,30,30,15715422,15715905,500,15713691,15714477,931,15715408
2310,8,8,15721815,15721932,134,15720500,15721291,514,15721805
2311,10,10,15728625,15728774,166,15727309,15728105,501,15728606
2312,60,60,15735833,15736816,999,15734135,15734919,907,15735826
2313,56,56,15742693,15743608,932,15740945,15741733,956,15742689
2314,16,16,15749186,15749435,266,15747754,15748547,631,15749178
2315,16,16,15756311,15756561,267,15754563,15755361,936,15756297
2316,42,42,15763071,15763753,699,15761389,15762175,878,15763053
2317,10,10,15769863,15770013,167,15768198,15768989,861,15769850
2318,50,50,15776439,15777255,833,15775008,15775803,632,15776435
2319,36,36,15783582,15784164,599,15781834,15782617,956,15783573
2320,44,44,15790341,15791057,733,15788643,15789431,894,15790325
2321,8,8,15797184,15797300,133,15795452,15796245,932,15797177
2322,18,18,15803876,15804159,300,15802261,15803059,800,15803859
2323,30,30,15810586,15811069,499,15809087,15809873,703,15810576
2324,30,30,15817545,15818028,499,15815897,15816687,840,15817527
2325,2,2,15824271,15824288,33,15822706,15823501,753,15824254
2326,14,14,15830880,15831097,234,15829532,15830315,561,15830876
2327,34,34,15838039,15838589,566,15836341,15837129,901,15838030
2328,58,58,15844466,15845415,965,15843150,15843943,517,15844460
2329,30,30,15851708,15852191,499,15849960,15850757,944,15851701
2330,6,6,15858534,15858617,100,15856786,15857571,960,15858531
2331,34,34,15865310,15865859,566,15863595,15864385,919,15865304
2332,20,20,15872002,15872319,333,15870404,15871199,787,15871986
2333,18,18,15878612,15878895,300,15877230,15878013,583,15878596
2334,26,26,15885471,15885887,433,15884039,15884827,628,15885455
2335,16,16,15892314,15892564,266,15890849,15891641,664,15892305
2336,24,24,15899389,15899772,400,15897658,15898455,931,15899386
2337,58,58,15906132,15907081,966,15904484,15905269,849,15906118
2338,50,50,15912975,15913791,832,15911293,15912083,879,15912962
2339,52,52,15919701,15920550,866,15918103,15918897,797,15919694
2340,30,30,15926710,15927193,499,15924928,15925711,996,15926707
2341,6,6,15933419,15933502,100,15931738,15932525,890,15933415
2342,10,10,15939879,15940029,166,15938547,15939339,530,15939869
2343,40,40,15947138,15947787,666,15945356,15946153,977,15947130
2344,46,46,15953697,15954446,766,15952182,15952967,722,15953689
2345,14,14,15960423,15960640,233,15958992,15959781,625,15960406
2346,28,28,15967316,15967765,466,15965801,15966595,715,15967310
2347,16,16,15974375,15974625,266,15972610,15973409,963,15974372
2348,38,38,15981051,15981667,633,15979436,15980223,812,15981035
2349,36,36,15987894,15988476,599,15986245,15987037,848,15987885
2350,60,60,15994603,15995585,999,15993055,15993851,739,15994590
2351,38,38,16001545,16002161,633,15999881,16000665,866,16001531
2352,4,4,16008105,16008155,67,16006690,16007479,608,16008087
2353,58,58,16015114,16016063,966,16013499,16014293,805,16015098
2354,12,12,16021724,16021907,199,16020308,16021107,611,16021718
2355,38,38,16028849,16029465,633,16027134,16027921,924,16028845
2356,18,18,16035542,16035825,300,16033944,16034735,795,16035530
2357,16,16,16042101,16042351,267,16040753,16041549,537,16042086
2358,42,42,16049360,16050043,700,16047579,16048363,992,16049355
2359,58,58,16055870,16056819,965,16054388,16055177,682,16055859
2360,30,30,16062679,16063162,500,16061197,16061991,681,16062672
2361,42,42,16069788,16070471,699,16068007,16068805,980,16069785
2362,54,54,16076481,16077363,899,16074833,16075619,855,16076474
2363,40,40,16083423,16084073,666,16081642,16082433,985,16083418
2364,8,8,16090199,16090316,134,16088451,16089247,946,16090193
2365,38,38,16097009,16097625,632,16095277,16096061,932,16096993
2366,54,54,16103884,16104767,900,16102086,16102875,996,16103871
2367,56,56,16110261,16111177,932,16108896,16109689,557,16110246
2368,32,32,16117503,16118019,533,16115705,16116503,995,16117498
2369,6,6,16124013,16124096,100,16122531,16123317,683,16124000
2370,34,34,16131005,16131554,566,16129340,16130131,866,16130997
2371,60,60,16137881,16138863,999,16136150,16136945,931,16137876
2372,40,40,16144740,16145389,666,16142975,16143759,975,16144734
2373,18,18,16151233,16151516,300,16149785,16150573,647,16151220
2374,22,22,16158092,16158442,367,16156594,16157387,701,16158088
2375,60,60,16165101,16166084,999,16163403,16164201,882,16165083
2376,50,50,16171761,16172577,832,16170229,16171015,733,16171748
2377,4,4,16178570,16178620,67,16177039,16177829,731,16178560
2378,12,12,16185180,16185363,199,16183848,16184643,520,16185163
2379,46,46,16192006,16192755,765,16190674,16191457,544,16192001
2380,30,30,16198898,16199381,500,16197483,16198271,611,16198882
2381,16,16,16205707,16205957,267,16204292,16205085,613,16205698
2382,58,58,16212866,16213815,966,16211102,16211899,956,16212855
2383,8,8,16219359,16219476,134,16217928,16218713,630,16219343
2384,14,14,16226152,16226368,233,16224737,16225527,613,16226140
2385,58,58,16233144,16234093,966,16231546,16232341,789,16233130
2386,44,44,16240020,16240736,733,16238372,16239155,847,16240002
2387,2,2,16246813,16246830,33,16245181,16245969,837,16246806
2388,8,8,16253739,16253855,133,16251991,16252783,939,16253722
2389,52,52,16260348,16261197,866,16258800,16259597,735,16260332
2390,22,22,16267024,16267374,367,16265626,16266411,611,16267022
2391,32,32,16273933,16274450,533,16272435,16273225,703,16273928
2392,46,46,16280676,16281425,766,16279244,16280039,631,16280670
2393,14,14,16287386,16287602,233,16286070,16286853,518,16287371
2394,44,44,16294195,16294911,732,16292880,16293667,513,16294180
2395,2,2,16301204,16301221,33,16299689,16300481,710,16301191
2396,18,18,16307813,16308096,300,16306498,16307295,500,16307795
2397,16,16,16315039,16315289,266,16313324,16314109,922,16315031
2398,46,46,16321898,16322647,766,16320133,16320923,958,16321881
2399,28,28,16328358,16328807,466,16326943,16327737,605,16328342
2400,56,56,16335217,16336133,932,16333752,16334551,661,16335212
2401,48,48,16341893,16342676,799,16340578,16341365,519,16341884
2402,34,34,16348902,16349452,566,16347387,16348179,716,16348895
2403,52,52,16355945,16356794,865,16354196,16354993,935,16355928
2404,40,40,16362554,16363203,666,16361022,16361807,739,16362546
2405,42,42,16369180,16369863,700,16367832,16368621,557,16369178
2406,28,28,16375990,16376439,466,16374641,16375435,537,16375972
2407,4,4,16383232,16383282,66,16381450,16382249,966,16383215
2408,56,56,16389874,16390790,933,16388276,16389063,794,16389857
2409,28,28,16396534,16396983,466,16395085,16395877,651,16396528
2410,60,60,16403343,16404325,999,16401895,16402691,650,16403341
2411,14,14,16410069,16410286,233,16408721,16409505,559,16410064
2412,36,36,16416845,16417428,600,16415530,16416319,518,16416837
2413,40,40,16423754,16424404,666,16422339,16423133,605,16423738
2414,52,52,16430664,16431513,865,16429149,16429947,704,16430651
2415,4,4,16437423,16437473,67,16435975,16436761,650,16437411
2416,54,54,16444499,16445381,899,16442784,16443575,915,16444490
2417,24,24,16450992,16451374,399,16449593,16450389,588,16450977
2418,30,30,16458034,16458517,499,16456419,16457203,817,16458020
2419,46,46,16464926,16465676,766,16463228,16464017,907,16464924
2420,14,14,16471719,16471936,233,16470038,16470831,871,16471702
2421,48,48,16478179,16478961,799,16476847,16477645,518,16478163
2422,2,2,16485321,16485338,33,16483673,16484459,860,16485319
2423,50,50,16492180,16492996,833,16490482,16491273,892,16492165
2424,58,58,16498623,16499572,966,16497291,16498087,532,16498619
2425,14,14,16505899,16506115,233,16504117,16504901,982,16505883
2426,16,16,16512525,16512775,266,16510927,16511715,801,16512516
2427,42,42,16519251,16519933,699,16517736,16518529,707,16519236
2428,32,32,16526160,16526676,533,16524545,16525343,809,16526152
2429,12,12,16532803,16532986,200,16531371,16532157,633,16532790
2430,48,48,16539862,16540644,799,16538180,16538971,877,16539848
2431,50,50,16546671,16547487,833,16544990,16545785,879,16546664
2432,48,48,16553414,16554196,799,16551816,16552599,807,16553406
2433,28,28,16560390,16560839,466,16558625,16559413,963,16560376
2434,36,36,16566766,16567349,599,16565434,16566227,525,16566752
2435,36,36,16573858,16574441,600,16572243,16573041,805,16573846
2436,48,48,16580801,16581583,799,16579069,16579855,932,16580787
2437,56,56,16587677,16588592,932,16585879,16586669,999,16587668
2438,20,20,16594003,16594320,333,16592688,16593483,511,16593994
2439,50,50,16601112,16601928,833,16599514,16600297,807,16601104
2440,44,44,16607955,16608671,732,16606323,16607111,833,16607944
2441,10,10,16614797,16614947,167,16613132,16613925,867,16614792
2442,14,14,16621640,16621856,233,16619942,16620739,897,16621636
2443,46,46,16628349,16629099,766,16626768,16627553,782,16628335
2444,26,26,16634942,16635358,433,16633577,16634367,565,16634932
2445,44,44,16642051,16642767,733,16640386,16641181,865,16642046
2446,30,30,16648894,16649377,499,16647212,16647995,888,16648883
2447,22,22,16655670,16656019,366,16654021,16654809,851,16655660
2448,20,20,16662346,16662662,333,16660831,16661623,718,16662341
2449,56,56,16669005,16669921,933,16667640,16668437,556,16668993
2450,48,48,16676164,16676947,799,16674466,16675251,900,16676151
2451,40,40,16682824,16683473,666,16681275,16682065,744,16682809
2452,60,60,16689416,16690399,999,16688085,16688879,530,16689409
2453,56,56,16696675,16697591,933,16694911,16695693,968,16696661
2454,10,10,16703085,16703235,166,16701720,16702507,572,16703079
2455,30,30,16710077,16710560,500,16708529,16709321,754,16710075
2456,56,56,16716670,16717586,933,16715338,16716135,530,16716665
2457,16,16,16723596,16723846,266,16722164,16722949,631,16723580
2458,56,56,16730405,16731321,933,16728974,16729763,624,16730387
2459,22,22,16737298,16737648,366,16735783,16736577,705,16737282
2460,38,38,16744007,16744623,633,16742592,16743391,606,16743997
2461,18,18,16750966,16751249,300,16749418,16750205,757,16750962
2462,30,30,16757876,16758358,499,16756227,16757019,842,16757861
2463,26,26,16764685,16765101,433,16763037,16763833,841,16764674
2464,14,14,16771178,16771394,233,16769863,16770647,527,16771174
2465,12,12,16778070,16778253,200,16776672,16777461,603,16778064
2466,30,30,16784963,16785446,499,16783481,16784275,682,16784957
2467,28,28,16792005,16792455,466,16790290,16791089,901,16791990
2468,36,36,16798648,16799231,599,16797116,16797903,730,16798633
2469,10,10,16805541,16805690,166,16803926,16804717,817,16805534
2470,52,52,16812450,16813299,866,16810735,16811531,915,16812446
2471,38,38,16818909,16819525,633,16817561,16818345,550,16818895
2472,50,50,16826068,16826884,833,16824370,16825159,895,16826054
2473,8,8,16832811,16832928,133,16831179,16831973,835,16832808
2474,60,60,16839587,16840569,999,16837989,16838787,786,16839573
2475,44,44,16846496,16847212,733,16844815,16845601,883,16846484
2476,54,54,16852956,16853838,899,16851624,16852415,531,16852946
2477,36,36,16859932,16860514,599,16858433,16859229,695,16859924
2478,32,32,16867007,16867523,533,16865259,16866043,961,16867004
2479,36,36,16873633,16874216,600,16872068,16872857,758,16873615
2480,48,48,16880443,16881225,799,16878878,16879671,766,16880437
2481,48,48,16887169,16887951,799,16885687,16886485,674,16887159
2482,28,28,16894211,16894661,466,16892513,16893299,907,16894206
2483,24,24,16900854,16901237,400,16899322,16900113,737,16900850
2484,56,56,16907513,16908429,933,16906132,16906927,569,16907496
2485,14,14,16914622,16914839,233,16912957,16913741,875,16914616
2486,50,50,16921282,16922098,832,16919767,16920555,720,16921275
2487,30,30,16928024,16928507,500,16926576,16927369,637,16928006
2488,14,14,16934967,16935183,233,16933385,16934183,778,16934961
2489,52,52,16941959,16942808,866,16940211,16940997,948,16941945
2490,22,22,16948469,16948819,366,16947021,16947811,652,16948463
2491,60,60,16955312,16956294,999,16953830,16954625,668,16955293
2492,2,2,16962321,16962337,33,16960656,16961439,878,16962317
2493,20,20,16968980,16969296,333,16967465,16968253,720,16968973
2494,34,34,16975923,16976472,566,16974274,16975067,848,16975915
2495,40,40,16982499,16983148,666,16981084,16981881,606,16982487
2496,42,42,16989491,16990174,699,16987910,16988695,782,16989477
2497,20,20,16996151,16996467,333,16994719,16995509,632,16996141
2498,28,28,17003143,17003593,466,17001528,17002323,815,17003138
2499,44,44,17010019,17010735,732,17008354,17009137,869,17010006
2500,18,18,17016712,17016995,299,17015163,17015951,747,17016698
2501,6,6,17023737,17023821,100,17021973,17022765,959,17023724
2502,52,52,17030164,17031013,866,17028782,17029579,582,17030161
2503,34,34,17037389,17037939,566,17035608,17036393,991,17037384
2504,46,46,17044165,17044914,766,17042417,17043207,940,17044147
2505,60,60,17050658,17051640,999,17049226,17050021,623,17050644
2506,6,6,17057767,17057850,100,17056052,17056835,928,17057763
2507,42,42,17064277,17064959,699,17062862,17063649,621,17064270
2508,12,12,17071003,17071186,200,17069671,17070463,526,17070989
2509,34,34,17078078,17078628,567,17076480,17077277,790,17078067
2510,24,24,17084971,17085354,400,17083306,17084091,872,17084963
2511,12,12,17091514,17091697,200,17090115,17090905,594,17091499
2512,10,10,17098290,17098440,166,17096925,17097719,559,17098278
2513,54,54,17105316,17106198,899,17103734,17104533,780,17105313
2514,12,12,17111975,17112158,200,17110560,17111347,613,17111960
2515,18,18,17118934,17119217,300,17117369,17118161,762,17118923
2516,14,14,17125860,17126076,233,17124179,17124975,882,17125857
2517,32,32,17132420,17132936,532,17131004,17131789,612,17132401
2518,34,34,17139429,17139978,566,17137814,17138603,823,17139426
2519,24,24,17146005,17146388,399,17144623,17145417,583,17146000
2520,54,54,17153147,17154029,899,17151432,17152231,908,17153139
2521,46,46,17159790,17160539,766,17158258,17159045,733,17159778
2522,52,52,17166616,17167465,866,17165068,17165859,741,17166600
2523,50,50,17173309,17174124,832,17171877,17172673,622,17173295
2524,42,42,17180484,17181167,699,17178703,17179487,988,17180475
2525,44,44,17187060,17187776,733,17185512,17186301,754,17187055
2526,8,8,17193720,17193836,133,17192321,17193115,593,17193708
2527,34,34,17200696,17201245,566,17199131,17199929,753,17200682
2528,38,38,17207538,17208154,633,17205957,17206743,786,17207529
2529,24,24,17214447,17214830,400,17212766,17213557,879,17214436
2530,32,32,17221223,17221739,533,17219575,17220371,841,17221212
2531,14,14,17227700,17227916,233,17226401,17227185,511,17227696
2532,58,58,17234526,17235475,965,17233210,17233999,516,17234515
2533,10,10,17241518,17241668,167,17240020,17240813,695,17241508
2534,42,42,17248211,17248893,699,17246829,17247627,574,17248201
2535,46,46,17255137,17255886,765,17253655,17254441,686,17255127
2536,22,22,17261979,17262329,366,17260464,17261255,712,17261967
2537,30,30,17268938,17269421,500,17267273,17268069,863,17268932
2538,52,52,17275564,17276414,866,17274099,17274883,679,17275562
2539,54,54,17282457,17283339,899,17280909,17281697,748,17282445
2540,12,12,17289416,17289599,200,17287718,17288511,901,17289412
2541,8,8,17295909,17296026,133,17294527,17295325,575,17295900
2542,26,26,17302785,17303201,433,17301353,17302139,636,17302775
2543,4,4,17309744,17309794,67,17308162,17308953,787,17309740
2544,10,10,17316720,17316870,166,17314972,17315767,940,17316707
2545,48,48,17323562,17324345,800,17321798,17322581,976,17323557
2546,16,16,17330388,17330638,267,17328607,17329395,981,17330376
2547,4,4,17337014,17337064,67,17335416,17336209,793,17337002
2548,46,46,17343840,17344590,766,17342226,17343023,804,17343827
2549,4,4,17350367,17350417,66,17349051,17349837,525,17350362
2550,44,44,17357176,17357892,733,17355861,17356651,513,17357164
2551,34,34,17364135,17364684,566,17362670,17363465,661,17364126
2552,38,38,17370861,17371477,633,17369496,17370279,566,17370845
2553,24,24,17378037,17378420,399,17376305,17377093,937,17378030
2554,2,2,17384779,17384796,34,17383115,17383907,855,17384762
2555,52,52,17391522,17392371,866,17389924,17390721,799,17391520
2556,14,14,17398132,17398348,233,17396750,17397535,593,17398128
2557,8,8,17404974,17405091,133,17403559,17404349,618,17404967
2558,28,28,17411717,17412166,466,17410368,17411163,551,17411714
2559,30,30,17418826,17419309,499,17417194,17417977,832,17418809
2560,60,60,17425635,17426617,999,17424004,17424791,840,17425631
2561,56,56,17431396,17432311,932,17430813,17430822,558,17431380
2562,22,22,17438621,17438971,366,17436840,17437636,981,17438617
2563,56,56,17445064,17445980,932,17443666,17444450,606,17445056
2564,40,40,17452106,17452756,666,17450475,17451264,837,17452101
2565,8,8,17458832,17458949,134,17457284,17458078,737,17458815
2566,26,26,17465825,17466241,433,17464093,17464892,921,17465813
2567,54,54,17472351,17473233,899,17470919,17471706,628,17472334
2568,34,34,17479227,17479776,566,17477729,17478520,703,17479223
2569,4,4,17486003,17486053,67,17484538,17485334,659,17485993
2570,38,38,17492929,17493545,632,17491364,17492148,776,17492924
2571,8,8,17499555,17499672,133,17498173,17498962,578,17499540
2572,32,32,17506597,17507113,533,17504982,17505776,819,17506595
2573,44,44,17513323,17514039,733,17511792,17512590,723,17513313
2574,38,38,17520066,17520682,633,17518618,17519404,645,17520049
2575,56,56,17527009,17527924,932,17525427,17526218,780,17526998
2576,30,30,17533818,17534301,499,17532236,17533032,772,17533804
2577,30,30,17540744,17541226,499,17539062,17539846,885,17540731
2578,36,36,17547353,17547936,600,17545871,17546660,685,17547345
2579,2,2,17554429,17554445,33,17552681,17553474,943,17554417
2580,28,28,17561122,17561571,466,17559490,17560288,831,17561119
2581,44,44,17568031,17568747,732,17566316,17567102,919,17568021
2582,22,22,17574674,17575023,366,17573125,17573916,754,17574670
2583,6,6,17581283,17581366,100,17579935,17580730,544,17581274
2584,38,38,17588159,17588775,633,17586760,17587544,607,17588151
2585,32,32,17595268,17595784,533,17593570,17594358,896,17595254
2586,36,36,17602110,17602693,600,17600379,17601172,920,17602092
2587,52,52,17608537,17609386,866,17607188,17607986,538,17608524
2588,32,32,17615712,17616228,533,17614014,17614800,899,17615699
2589,28,28,17622555,17623004,466,17620824,17621614,938,17622552
2590,50,50,17629065,17629880,832,17627633,17628428,631,17629059
2591,14,14,17635907,17636124,233,17634459,17635242,652,17635894
2592,50,50,17642733,17643549,833,17641268,17642056,664,17642720
2593,22,22,17649592,17649942,367,17648077,17648870,709,17649579
2594,32,32,17656618,17657134,533,17654887,17655684,931,17656615
2595,60,60,17663261,17664243,999,17661713,17662498,752,17663250
2596,46,46,17669937,17670686,766,17668522,17669312,622,17669934
2597,32,32,17677029,17677545,533,17675331,17676126,899,17677025
2598,6,6,17683855,17683938,100,17682157,17682940,897,17683837
2599,12,12,17690415,17690598,200,17688966,17689754,650,17690404
2600,14,14,17697474,17697690,233,17695776,17696568,895,17697463
2601,42,42,17704050,17704733,699,17702585,17703382,666,17704048
2602,22,22,17710893,17711242,366,17709411,17710196,691,17710887
2603,56,56,17718002,17718917,932,17716220,17717010,989,17717999
2604,40,40,17724777,17725427,666,17723029,17723824,940,17724764
2605,4,4,17731454,17731504,66,17729855,17730638,803,17731441
2606,58,58,17738146,17739095,966,17736665,17737452,682,17738134
2607,40,40,17745205,17745855,666,17743474,17744266,927,17745193
2608,38,38,17751948,17752564,633,17750283,17751080,850,17751930
2609,12,12,17758524,17758707,200,17757109,17757894,614,17758508
2610,26,26,17765533,17765950,433,17763918,17764708,807,17765515
2611,28,28,17772326,17772775,466,17770728,17771522,799,17772321
2612,28,28,17778869,17779318,466,17777537,17778336,518,17778854
2613,34,34,17785978,17786527,566,17784363,17785150,813,17785963
2614,12,12,17792904,17793087,199,17791172,17791964,934,17792898
2615,56,56,17799480,17800396,932,17797981,17798778,697,17799475
2616,32,32,17806356,17806872,533,17804807,17805592,751,17806343
2617,16,16,17813282,17813531,266,17811617,17812406,861,17813267
2618,16,16,17819891,17820141,266,17818426,17819220,665,17819885
2619,26,26,17826883,17827300,433,17825235,17826034,840,17826874
2620,28,28,17833526,17833976,466,17832061,17832848,675,17833523
2621,24,24,17840269,17840652,400,17838870,17839662,599,17840261
2622,46,46,17847028,17847778,766,17845680,17846476,536,17847012
2623,60,60,17853954,17854936,999,17852506,17853290,658,17853948
2624,12,12,17861030,17861213,200,17859315,17860104,923,17861027
2625,54,54,17867856,17868738,899,17866124,17866918,927,17867845
2626,4,4,17874499,17874548,66,17872934,17873732,764,17874496
2627,4,4,17881241,17881291,67,17879760,17880546,684,17881230
2628,42,42,17888284,17888966,699,17886569,17887360,915,17888275
2629,58,58,17894760,17895709,966,17893378,17894174,574,17894748
2630,24,24,17901869,17902252,399,17900204,17900988,872,17901860
2631,30,30,17908678,17909161,500,17907013,17907802,866,17908668
2632,38,38,17915288,17915904,632,17913823,17914616,661,17915277
2633,22,22,17921215,17921564,366,17920632,17920647,565,17921212
2634,4,4,17928174,17928224,66,17926675,17927461,706,17928167
2635,44,44,17935183,17935899,732,17933485,17934275,903,17935178
2636,12,12,17942092,17942275,200,17940294,17941089,995,17942084
2637,38,38,17948685,17949301,632,17947120,17947903,774,17948677
2638,60,60,17955644,17956626,999,17953929,17954717,922,17955639
2639,54,54,17962070,17962953,899,17960738,17961531,532,17962063
2640,6,6,17968913,17968996,100,17967548,17968345,557,17968902
2641,46,46,17975889,17976638,765,17974374,17975159,724,17975883
2642,30,30,17982948,17983430,499,17981183,17981973,958,17982931
2643,60,60,17989341,17990323,999,17987992,17988787,551,17989338
2644,14,14,17996416,17996633,233,17994818,17995601,807,17996408
2645,12,12,18003326,18003509,199,18001627,18002415,907,18003322
2646,50,50,18010085,18010901,832,18008437,18009229,838,18010067
2647,2,2,18016678,18016694,33,18015246,18016043,624,18016667
2648,10,10,18023437,18023587,167,18022072,18022857,567,18023424
2649,22,22,18030546,18030896,366,18028881,18029671,865,18030536
2650,42,42,18037106,18037788,699,18035690,18036485,604,18037089
2651,48,48,18043998,18044781,799,18042516,18043299,695,18043994
2652,44,44,18050741,18051457,732,18049326,18050113,613,18050726
2653,8,8,18057933,18058050,133,18056135,18056927,996,18057923
2654,16,16,18064659,18064909,266,18062944,18063741,914,18064655
2655,42,42,18071119,18071801,699,18069770,18070555,558,18071113
2656,24,24,18078278,18078661,399,18076579,18077369,898,18078267
2657,38,38,18084804,18085420,633,18083389,18084183,604,18084787
2658,34,34,18091813,18092362,566,18090198,18090997,798,18091795
2659,48,48,18098506,18099288,799,18097024,18097811,680,18098491
2660,56,56,18105465,18106381,932,18103833,18104625,822,18105447
2661,28,28,18112257,18112707,467,18110643,18111439,814,18112253
2662,10,10,18119250,18119400,166,18117469,18118253,992,18119245
2663,50,50,18126026,18126842,832,18124278,18125067,944,18126011
2664,18,18,18132419,18132702,300,18131087,18131881,535,18132416
2665,36,36,18139561,18140144,600,18137896,18138695,853,18139548
2666,46,46,18146271,18147020,765,18144722,18145509,756,18146265
2667,42,42,18152863,18153546,700,18151532,18152323,535,18152858
2668,60,60,18159989,18160971,999,18158341,18159137,850,18159987
2669,54,54,18166815,18167697,899,18165167,18165951,849,18166800
2670,14,14,18173441,18173658,233,18171976,18172765,669,18173434
2671,8,8,18180317,18180434,133,18178785,18179579,720,18180299
2672,56,56,18186560,18187476,933,18185595,18185610,948,18186558
2673,44,44,18193253,18193969,733,18191638,18192424,827,18193251
2674,24,24,18200029,18200412,400,18198447,18199238,787,18200025
2675,26,26,18206605,18207021,433,18205257,18206052,539,18206591
2676,42,42,18213698,18214380,699,18212083,18212866,829,18213695
2677,24,24,18220274,18220657,399,18218892,18219680,586,18220266
2678,34,34,18227283,18227832,566,18225701,18226494,782,18227276
2679,40,40,18234142,18234791,666,18232510,18233308,827,18234135
2680,36,36,18240851,18241434,600,18239336,18240122,713,18240835
2681,4,4,18247811,18247860,66,18246146,18246936,858,18247794
2682,44,44,18254703,18255419,733,18252955,18253750,938,18254688
2683,30,30,18261246,18261729,499,18259781,18260564,667,18261231
2684,50,50,18268288,18269104,833,18266590,18267378,900,18268278
2685,16,16,18275081,18275331,266,18273399,18274192,874,18275066
2686,58,58,18281774,18282723,965,18280209,18281006,761,18281767
2687,50,50,18288633,18289449,832,18287035,18287820,795,18288615
2688,24,24,18295259,18295642,400,18293844,18294634,609,18295243
2689,60,60,18302168,18303151,999,18300653,18301448,709,18302157
2690,60,60,18309077,18310060,999,18307479,18308262,802,18309064
2691,22,22,18315737,18316087,366,18314288,18315076,643,18315719
2692,58,58,18322580,18323528,965,18321098,18321890,672,18322562
2693,22,22,18329439,18329788,366,18327907,18328704,724,18329428
2694,52,52,18336431,18337280,866,18334733,18335518,910,18336428
2695,22,22,18343174,18343523,366,18341542,18342332,830,18343162
2696,24,24,18350100,18350483,399,18348352,18349146,946,18350092
2697,56,56,18356676,18357592,932,18355178,18355960,708,18356668
2698,58,58,18363385,18364334,966,18361987,18362774,609,18363383
2699,4,4,18370311,18370361,67,18368796,18369588,708,18370296
2700,52,52,18376971,18377820,865,18375605,18376402,559,18376961
2701,12,12,18383913,18384096,200,18382431,18383216,689,18383905
2702,54,54,18390972,18391854,899,18389241,18390030,924,18390954
2703,46,46,18397715,18398464,766,18396050,18396844,862,18397706
2704,40,40,18404174,18404824,666,18402859,18403658,500,18404158
2705,38,38,18411017,18411633,633,18409685,18410472,536,18411008
2706,50,50,18417893,18418709,832,18416494,18417286,599,18417885
2707,48,48,18424685,18425468,800,18423304,18424100,567,18424667
2708,46,46,18431461,18432211,766,18430130,18430914,534,18431448
2709,2,2,18438354,18438371,33,18436939,18437728,615,18438343
2710,56,56,18445113,18446029,933,18443748,18444542,558,18445100
2711,50,50,18452272,18453088,833,18450557,18451356,899,18452255
2712,46,46,18458965,18459714,766,18457383,18458170,784,18458954
2713,42,42,18465624,18466307,700,18464193,18464984,631,18465615
2714,16,16,18472550,18472800,267,18471002,18471798,743,18472541
2715,16,16,18479376,18479626,267,18477828,18478612,757,18479369
2716,22,22,18486252,18486602,366,18484637,18485426,821,18486247
2717,58,58,18493211,18494160,966,18491446,18492240,959,18493199
2718,30,30,18499954,18500437,499,18498256,18499054,886,18499940
2719,58,58,18506763,18507712,966,18505082,18505868,886,18506754
2720,8,8,18513240,18513356,133,18511891,18512682,544,18513226
2721,10,10,18520448,18520598,167,18518700,18519496,940,18520436
2722,38,38,18527208,18527824,632,18525526,18526310,882,18527192
2723,46,46,18533751,18534500,765,18532335,18533124,618,18533742
2724,18,18,18540860,18541143,299,18539145,18539938,918,18540856
2725,42,42,18547353,18548035,699,18545954,18546752,593,18547345
2726,48,48,18554461,18555244,800,18552780,18553566,892,18554458
2727,56,56,18561304,18562220,932,18559589,18560380,910,18561290
2728,2,2,18568080,18568097,33,18566399,18567194,877,18568071
2729,6,6,18574590,18574673,100,18573224,18574008,566,18574574
2730,8,8,18581482,18581599,133,18580034,18580822,648,18581470
2731,34,34,18588208,18588758,566,18586843,18587636,568,18588204
2732,42,42,18595350,18596033,700,18593652,18594450,887,18595337
2733,34,34,18602193,18602742,566,18600478,18601264,912,18602176
2734,6,6,18608603,18608686,100,18607288,18608078,511,18608589
2735,30,30,18615712,18616195,499,18614097,18614892,810,18615702
2736,16,16,18622438,18622688,266,18620923,18621706,723,18622429
2737,8,8,18629064,18629180,133,18627732,18628520,533,18629053
2738,14,14,18635923,18636140,233,18634541,18635334,585,18635919
2739,26,26,18642816,18643232,433,18641351,18642148,665,18642813
2740,40,40,18649908,18650557,666,18648177,18648962,940,18649902
2741,22,22,18656601,18656950,366,18654986,18655776,822,18656598
2742,48,48,18663177,18663959,799,18661795,18662590,573,18663163
2743,58,58,18670353,18671302,965,18668621,18669404,938,18670342
2744,22,22,18676879,18677228,366,18675430,18676218,643,18676861
2745,46,46,18683954,18684704,766,18682240,18683032,916,18683948
2746,38,38,18690581,18691197,632,18689049,18689846,716,18690562
2747,28,28,18697190,18697640,466,18695875,18696660,523,18697183
2748,8,8,18704216,18704332,133,18702684,18703474,736,18704210
2749,20,20,18710875,18711192,333,18709493,18710288,578,18710866
2750,38,38,18717968,18718584,632,18716319,18717102,859,18717961
2751,52,52,18724877,18725726,866,18723129,18723916,953,18724869
2752,12,12,18731320,18731503,200,18729938,18730730,574,18731304
2753,32,32,18738345,18738862,533,18736747,18737544,794,18738338
2754,12,12,18744922,18745105,200,18743573,18744358,546,18744904
2755,54,54,18751748,18752630,899,18750382,18751172,565,18751737
2756,20,20,18758873,18759190,333,18757192,18757986,871,18758857
2757,8,8,18765782,18765899,134,18764001,18764800,968,18765768
2758,46,46,18772592,18773341,766,18770827,18771614,970,18772584
2759,42,42,18779318,18780000,699,18777636,18778428,882,18779310
2760,50,50,18786227,18787043,832,18784446,18785242,970,18786212
2761,6,6,18792620,18792703,100,18791271,18792056,548,18792604
2762,32,32,18799662,18800178,533,18798081,18798870,781,18799651
2763,4,4,18806222,18806272,67,18804890,18805684,528,18806212
2764,24,24,18813081,18813464,400,18811699,18812498,574,18813072
2765,50,50,18819907,18820723,833,18818525,18819312,582,18819894
2766,26,26,18827033,18827449,433,18825335,18826126,900,18827026
2767,10,10,18833792,18833942,167,18832144,18832940,836,18833776
2768,16,16,18840685,18840934,266,18838970,18839754,920,18840674
2769,34,34,18847244,18847794,566,18845779,18846568,671,18847239
2770,16,16,18853970,18854220,267,18852588,18853382,574,18853956
2771,30,30,18861096,18861579,499,18859398,18860196,884,18861080
2772,52,52,18867689,18868538,865,18866224,18867010,671,18867681
2773,44,44,18874465,18875181,732,18873033,18873824,636,18874460
2774,10,10,18881590,18881740,167,18879842,18880638,947,18881585
2775,30,30,18888216,18888699,500,18886668,18887452,746,18888198
2776,30,30,18894959,18895442,500,18893477,18894266,681,18894947
2777,4,4,18901619,18901668,66,18900287,18901080,529,18901609
2778,18,18,18908478,18908761,299,18907096,18907894,567,18908461
2779,58,58,18915653,18916602,966,18913922,18914708,934,18915642
2780,32,32,18922396,18922912,533,18920731,18921522,862,18922384
2781,56,56,18928872,18929788,933,18927540,18928336,521,18928857
2782,42,42,18935981,18936664,700,18934366,18935150,825,18935975
2783,10,10,18942691,18942840,166,18941176,18941964,713,18942677
2784,40,40,18949616,18950266,666,18947985,18948778,829,18949607
2785,24,24,18956492,18956875,400,18954794,18955592,882,18956474
2786,36,36,18963202,18963784,599,18961620,18962406,780,18963186
2787,60,60,18970011,18970993,999,18968429,18969220,774,18969994
2788,8,8,18976637,18976754,133,18975239,18976034,593,18976627
2789,22,22,18983413,18983763,366,18982065,18982848,559,18983407
2790,42,42,18990239,18990922,699,18988874,18989662,561,18990223
2791,34,34,18997132,18997681,566,18995683,18996476,641,18997117
2792,14,14,19004141,19004357,233,19002493,19003290,835,19004125
2793,42,42,19010833,19011516,700,19009318,19010104,717,19010821
2794,12,12,19017526,19017709,200,19016128,19016918,594,19017512
2795,16,16,19024452,19024702,266,19022937,19023732,711,19024443
2796,34,34,19031378,19031927,566,19029763,19030546,820,19031366
2797,32,32,19038071,19038587,532,19036572,19037360,701,19038061
2798,54,54,19044847,19045729,899,19043382,19044174,658,19044832
2799,12,12,19051939,19052122,200,19050191,19050988,943,19051931
2800,38,38,19058399,19059015,632,19057017,19057802,580,19058382
2801,2,2,19065141,19065158,34,19063826,19064616,510,19065126
2802,6,6,19072234,19072317,99,19070635,19071430,795,19072225
2803,52,52,19079093,19079942,866,19077461,19078244,836,19079080
2804,38,38,19085985,19086601,633,19084271,19085058,922,19085980
2805,16,16,19092578,19092828,267,19091080,19091872,703,19092575
2806,46,46,19099637,19100386,766,19097889,19098686,942,19099628
2807,18,18,19106430,19106713,300,19104715,19105500,914,19106414
2808,56,56,19112873,19113789,932,19111524,19112314,546,19112860
2809,56,56,19120048,19120964,933,19118334,19119128,910,19120038
2810,14,14,19126858,19127074,233,19125160,19125942,910,19126852
2811,6,6,19133484,19133567,100,19131969,19132756,712,19133468
2812,10,10,19139461,19139611,166,19138778,19138787,661,19139448
2813,44,44,19146270,19146986,733,19144805,19145601,657,19146258
2814,16,16,19153063,19153312,266,19151631,19152415,643,19153058
2815,20,20,19159889,19160205,333,19158440,19159229,643,19159872
2816,16,16,19166914,19167164,267,19165249,19166043,868,19166911
2817,48,48,19173507,19174290,799,19172059,19172857,633,19173490
2818,54,54,19180416,19181299,899,19178885,19179671,732,19180403
2819,16,16,19187226,19187475,266,19185694,19186485,724,19187209
2820,50,50,19193902,19194717,832,19192503,19193299,587,19193886
2821,28,28,19200661,19201111,466,19199329,19200113,542,19200655
2822,32,32,19207770,19208286,533,19206138,19206927,832,19207759
2823,4,4,19214613,19214663,66,19212948,19213741,858,19214599
2824,60,60,19221089,19222071,999,19219757,19220555,527,19221082
2825,14,14,19227965,19228181,233,19226583,19227369,585,19227954
2826,30,30,19234757,19235240,500,19233392,19234183,569,19234752
2827,22,22,19241600,19241950,366,19240202,19240997,590,19241587
2828,50,50,19248609,19249425,833,19247027,19247811,780,19248591
2829,32,32,19255402,19255918,532,19253837,19254625,771,19255396
2830,52,52,19262211,19263060,866,19260646,19261439,766,19262205
2831,50,50,19269220,19270036,832,19267455,19268253,965,19269218
2832,48,48,19275646,19276429,800,19274281,19275067,566,19275633
2833,8,8,19282589,19282705,133,19281091,19281881,695,19282576
2834,60,60,19289232,19290214,999,19287900,19288695,519,19289214
2835,44,44,19296374,19297090,733,19294726,19295509,857,19296366
2836,32,32,19303167,19303683,532,19301535,19302323,826,19303149
2837,58,58,19310041,19310990,966,19308343,19309137,892,19310029
2838,8,8,19316634,19316751,134,19315153,19315951,672,19316623
2839,46,46,19323693,19324443,766,19321979,19322765,922,19323687
2840,48,48,19330569,19331352,799,19328788,19329579,981,19330560
2841,6,6,19337345,19337428,100,19335597,19336393,936,19337329
2842,58,58,19343988,19344937,966,19342423,19343207,774,19343981
2843,22,22,19350581,19350930,366,19349232,19350021,548,19350569
2844,20,20,19357840,19358156,333,19356042,19356835,990,19357825
2845,48,48,19364249,19365032,800,19362851,19363649,584,19364233
2846,2,2,19371025,19371042,34,19369677,19370463,550,19371013
2847,56,56,19377801,19378717,933,19376486,19377277,514,19377791
2848,36,36,19385044,19385626,599,19383295,19384091,935,19385026
2849,42,42,19391853,19392535,699,19390121,19390905,933,19391838
2850,16,16,19398546,19398795,266,19396931,19397719,817,19398536
2851,6,6,19405055,19405138,100,19403740,19404533,520,19405053
2852,18,18,19412064,19412347,300,19410549,19411347,706,19412053
2853,46,46,19418707,19419456,766,19417375,19418161,544,19418705
2854,50,50,19425699,19426515,833,19424184,19424975,716,19425691
2855,12,12,19432326,19432509,199,19430994,19431789,529,19432318
2856,54,54,19439484,19440367,900,19437820,19438603,864,19439467
2857,44,44,19446094,19446810,733,19444629,19445417,671,19446088
2858,10,10,19453236,19453386,167,19451438,19452231,988,19453219
2859,6,6,19459729,19459812,100,19458247,19459045,670,19459715
2860,34,34,19466538,19467088,567,19465073,19465859,674,19466533
2861,14,14,19473215,19473431,233,19471883,19472673,537,19473210
2862,12,12,19480407,19480590,200,19478692,19479487,913,19480400
2863,4,4,19487266,19487316,67,19485518,19486301,947,19487248
2864,52,52,19493826,19494675,865,19492327,19493115,702,19493817
2865,22,22,19500735,19501084,366,19499136,19499929,799,19500728
2866,8,8,19507627,19507744,133,19505946,19506743,868,19507611
2867,24,24,19514203,19514586,400,19512772,19513557,634,19514191
2868,60,60,19521179,19522162,999,19519581,19520371,802,19521173
2869,34,34,19527922,19528471,566,19526390,19527185,728,19527913
2870,40,40,19534848,19535497,666,19533216,19533999,832,19534831
2871,2,2,19541757,19541774,33,19540026,19540813,928,19541741
2872,12,12,19548550,19548733,199,19546835,19547627,904,19548531
2873,52,52,19555026,19555875,866,19553644,19554441,575,19555016
2874,8,8,19562002,19562118,133,19560470,19561255,738,19561993
2875,32,32,19569061,19569577,532,19567279,19568069,975,19569044
2876,44,44,19575554,19576270,732,19574089,19574883,661,19575544
2877,44,44,19582296,19583012,733,19580915,19581697,591,19582288
2878,20,20,19589039,19589355,333,19587724,19588511,523,19589034
2879,38,38,19596281,19596897,633,19594533,19595325,939,19596264
2880,32,32,19603041,19603557,532,19601342,19602139,897,19603036
2881,52,52,19609517,19610366,866,19608168,19608953,556,19609509
2882,26,26,19616759,19617175,433,19614978,19615767,987,19616754
2883,18,18,19623368,19623652,300,19621787,19622581,784,19623365
2884,6,6,19629928,19630011,100,19628596,19629395,518,19629913
2885,48,48,19637137,19637919,799,19635422,19636209,917,19637126
2886,50,50,19643896,19644712,833,19642231,19643023,868,19643891
2887,30,30,19650472,19650955,500,19649041,19649837,617,19650454
2888,6,6,19657282,19657365,100,19655867,19656651,613,19657264
2889,6,6,19664074,19664158,100,19662676,19663465,593,19664058
2890,54,54,19671250,19672132,899,19669485,19670279,966,19671245
2891,28,28,19677943,19678392,466,19676294,19677093,843,19677936
2892,4,4,19684602,19684652,67,19683120,19683907,678,19684585
2893,32,32,19691361,19691878,533,19689930,19690721,623,19691344
2894,34,34,19698420,19698970,567,19696739,19697535,867,19698402
2895,24,24,19705063,19705446,400,19703565,19704349,709,19705058
2896,20,20,19711873,19712189,333,19710374,19711163,698,19711861
2897,48,48,19718982,19719764,799,19717183,19717977,993,19718970
2898,56,56,19725391,19726307,933,19723993,19724791,584,19725375
2899,34,34,19732234,19732783,566,19730819,19731605,618,19732223
2900,10,10,19739176,19739326,167,19737628,19738419,741,19739160
2901,44,44,19745969,19746685,732,19744437,19745233,721,19745954
2902,24,24,19752995,19753378,399,19751263,19752047,940,19752987
2903,6,6,19759704,19759787,100,19758072,19758861,830,19759691
2904,26,26,19766563,19766979,433,19764882,19765675,876,19766551
2905,36,36,19773256,19773839,599,19771691,19772489,757,19773246
2906,52,52,19780132,19780981,866,19778517,19779303,825,19780128
2907,4,4,19786825,19786875,66,19785326,19786117,698,19786815
2908,38,38,19793817,19794433,633,19792136,19792931,881,19793812
2909,28,28,19800343,19800793,467,19798961,19799745,590,19800335
2910,16,16,19807236,19807486,266,19805771,19806559,663,19807222
2911,22,22,19814078,19814428,367,19812580,19813373,696,19814069
2912,36,36,19820988,19821570,599,19819389,19820187,798,19820985
2913,44,44,19827963,19828679,733,19826215,19827001,951,19827952
2914,40,40,19834689,19835339,666,19833025,19833815,872,19834687
2915,60,60,19841249,19842231,999,19839834,19840629,605,19841234
2916,54,54,19848042,19848924,899,19846660,19847443,581,19848024
2917,54,54,19854768,19855650,899,19853469,19854257,500,19854757
2918,10,10,19861743,19861893,167,19860278,19861071,657,19861728
2919,20,20,19868619,19868936,333,19867088,19867885,730,19868615
2920,16,16,19875645,19875895,266,19873914,19874699,940,19875639
2921,20,20,19882488,19882804,333,19880723,19881513,962,19882475
2922,18,18,19889130,19889413,300,19887532,19888327,788,19889115
2923,8,8,19895990,19896106,133,19894358,19895141,842,19895983
2924,22,22,19902782,19903132,367,19901167,19901955,810,19902765
2925,28,28,19909608,19910058,466,19907977,19908769,836,19909605
2926,34,34,19916567,19917117,566,19914786,19915583,979,19916562
2927,24,24,19923393,19923776,400,19921612,19922397,979,19923376
2928,22,22,19929753,19930103,366,19928421,19929211,540,19929751
2929,48,48,19936745,19937528,800,19935230,19936025,715,19936740
2930,54,54,19943555,19944437,899,19942056,19942839,704,19943543
2931,56,56,19950531,19951446,932,19948866,19949653,875,19950528
2932,30,30,19957440,19957923,499,19955675,19956467,966,19957433
2933,50,50,19964282,19965098,833,19962484,19963281,993,19964274
2934,20,20,19970642,19970958,333,19969310,19970095,537,19970632
2935,20,20,19977451,19977768,333,19976119,19976909,539,19977448
2936,22,22,19984327,19984677,367,19982929,19983723,590,19984313
2937,28,28,19991336,19991786,466,19989738,19990537,792,19991329
2938,10,10,19998329,19998479,166,19996564,19997351,974,19998325
2939,54,54,20005021,20005904,900,20003373,20004165,843,20005008
2940,8,8,20011531,20011648,133,20010183,20010979,546,20011525
2941,18,18,20018590,20018873,300,20017008,20017793,784,20018577
2942,46,46,20025483,20026232,765,20023818,20024607,859,20025466
2943,30,30,20032325,20032808,500,20030627,20031421,887,20032308
2944,16,16,20038851,20039101,267,20037436,20038235,603,20038838
2945,38,38,20045644,20046260,633,20044262,20045049,590,20045639
2946,32,32,20052753,20053269,533,20051072,20051863,886,20052749
2947,16,16,20059229,20059479,267,20057881,20058677,540,20059217
2948,50,50,20066039,20066854,832,20064707,20065491,542,20066033
2949,18,18,20073014,20073297,300,20071516,20072305,693,20072998
2950,30,30,20079774,20080257,499,20078325,20079119,638,20079757
2951,40,40,20086666,20087316,666,20085135,20085933,726,20086659
2952,42,42,20093426,20094108,699,20091961,20092747,675,20093422
2953,28,28,20100285,20100734,466,20098770,20099561,713,20100274
2954,32,32,20107194,20107710,533,20105579,20106375,817,20107192
2955,24,24,20113737,20114120,400,20112405,20113189,532,20113721
2956,36,36,20120879,20121462,600,20119214,20120003,873,20120876
2957,28,28,20127405,20127855,467,20126024,20126817,571,20127388
2958,20,20,20134365,20134681,333,20132833,20133631,718,20134349
2959,30,30,20141407,20141890,499,20139659,20140445,955,20141400
2960,50,50,20148266,20149082,833,20146468,20147259,996,20148255
2961,16,16,20154709,20154959,267,20153277,20154073,634,20154707
2962,40,40,20161818,20162467,666,20160103,20160887,924,20161811
2963,40,40,20168294,20168944,666,20166913,20167701,578,20168279
2964,4,4,20175237,20175287,67,20173722,20174515,706,20175221
2965,54,54,20182196,20183078,899,20180531,20181329,852,20182181
2966,56,56,20188839,20189755,932,20187357,20188143,680,20188823
2967,6,6,20195632,20195715,99,20194166,20194957,664,20195621
2968,54,54,20202408,20203290,899,20200976,20201771,634,20202405
2969,48,48,20209383,20210166,799,20207802,20208585,794,20209379
2970,8,8,20216076,20216193,133,20214611,20215399,667,20216066
2971,24,24,20222985,20223368,400,20221420,20222213,762,20222975
2972,4,4,20229944,20229994,67,20228230,20229027,909,20229936
2973,36,36,20236804,20237386,599,20235055,20235841,956,20236797
2974,48,48,20243197,20243979,799,20241865,20242655,537,20243192
2975,2,2,20250206,20250222,33,20248674,20249469,730,20250199
2976,30,30,20257048,20257531,500,20255500,20256283,761,20257044
2977,14,14,20264024,20264240,233,20262309,20263097,918,20264015
2978,16,16,20270850,20271100,266,20269119,20269911,932,20270843
2979,32,32,20277426,20277942,533,20275928,20276725,690,20277415
2980,22,22,20284502,20284851,366,20282754,20283539,949,20284488
2981,54,54,20291061,20291944,899,20289563,20290353,696,20291049
2982,46,46,20298087,20298836,766,20296372,20297167,904,20298071
2983,16,16,20304663,20304913,267,20303198,20303981,671,20304652
2984,4,4,20311506,20311556,67,20310008,20310795,693,20311488
2985,52,52,20318332,20319181,866,20316817,20317609,715,20318324
2986,20,20,20325108,20325424,333,20323626,20324423,676,20325099
2987,22,22,20331984,20332333,366,20330452,20331237,734,20331971
2988,58,58,20338743,20339692,966,20337261,20338051,680,20338731
2989,30,30,20345735,20346218,500,20344071,20344865,857,20345722
2990,18,18,20352245,20352528,300,20350897,20351679,558,20352237
2991,50,50,20359171,20359987,832,20357706,20358493,666,20359159
2992,4,4,20366080,20366130,67,20364515,20365307,764,20366071
2993,52,52,20372856,20373705,866,20371324,20372121,731,20372852
2994,8,8,20379699,20379815,133,20378150,20378935,758,20379693
2995,30,30,20386708,20387191,499,20384960,20385749,944,20386693
2996,48,48,20393184,20393967,799,20391769,20392563,609,20393172
2997,8,8,20400393,20400509,133,20398578,20399377,999,20400376
2998,14,14,20406886,20407102,233,20405404,20406191,692,20406883
2999,34,34,20413812,20414361,566,20412213,20413005,790,20413795
3000,52,52,20420638,20421487,865,20419023,20419819,802,20420621
3001,6,6,20427430,20427513,100,20425849,20426633,789,20427422
3002,24,24,20433973,20434356,400,20432658,20433447,522,20433969
3003,34,34,20441182,20441731,566,20439467,20440261,917,20441178
3004,34,34,20447758,20448308,566,20446276,20447075,680,20447755
3005,8,8,20454567,20454684,134,20453102,20453889,666,20454555
3006,32,32,20461377,20461893,533,20459912,20460703,669,20461372
3007,36,36,20468469,20469052,599,20466721,20467517,948,20468465
3008,48,48,20475012,20475794,799,20473547,20474331,671,20475002
3009,58,58,20481671,20482620,966,20480356,20481145,521,20481666
3010,26,26,20488614,20489030,433,20487165,20487959,644,20488603
3011,60,60,20495307,20496289,999,20493975,20494773,529,20495302
3012,44,44,20502582,20503298,733,20500801,20501587,978,20502565
3013,44,44,20508925,20509641,733,20507610,20508401,509,20508910
3014,50,50,20515951,20516767,832,20514419,20515215,720,20515935
3015,26,26,20522560,20522977,433,20521245,20522029,521,20522550
3016,20,20,20529769,20530086,333,20528055,20528843,913,20529756
3017,28,28,20536629,20537078,466,20534864,20535657,957,20536614
3018,50,50,20543405,20544220,832,20541673,20542471,926,20543397
3019,42,42,20549981,20550663,699,20548499,20549285,689,20549974
3020,34,34,20556957,20557506,566,20555308,20556099,841,20556940
3021,38,38,20563683,20564299,632,20562118,20562913,757,20563670
3022,10,10,20570658,20570808,167,20568944,20569727,921,20570648
3023,44,44,20577434,20578150,733,20575753,20576541,890,20577431
3024,42,42,20583877,20584560,700,20582562,20583355,506,20583861
3025,26,26,20590836,20591253,433,20589371,20590169,650,20590819
3026,42,42,20597529,20598212,699,20596197,20596983,537,20597520
3027,50,50,20604422,20605238,832,20603007,20603797,615,20604412
3028,40,40,20611464,20612113,666,20609816,20610611,850,20611461
3029,2,2,20618057,20618074,33,20616642,20617425,615,20618040
3030,2,2,20624850,20624866,33,20623451,20624239,594,20624833
3031,56,56,20631809,20632724,932,20630260,20631053,746,20631799
3032,2,2,20638701,20638718,34,20637070,20637867,829,20638696
3033,44,44,20645560,20646276,733,20643896,20644681,875,20645556
3034,36,36,20652020,20652603,600,20650705,20651495,514,20652009
3035,24,24,20659262,20659645,400,20657514,20658309,947,20659256
3036,32,32,20665705,20666221,533,20664340,20665123,579,20665702
3037,16,16,20672581,20672831,267,20671149,20671937,635,20672572
3038,52,52,20679307,20680156,866,20677959,20678751,545,20679296
3039,44,44,20686117,20686832,732,20684768,20685565,541,20686106
3040,34,34,20693342,20693891,566,20691594,20692379,960,20693339
3041,12,12,20699785,20699968,200,20698403,20699193,585,20699778
3042,60,60,20706661,20707643,999,20705212,20706007,636,20706643
3043,46,46,20713404,20714153,765,20712038,20712821,566,20713387
3044,40,40,20720230,20720879,665,20718848,20719635,581,20720216
3045,22,22,20727272,20727622,366,20725657,20726449,815,20727264
3046,38,38,20733798,20734414,633,20732466,20733263,527,20733790
3047,60,60,20740674,20741656,999,20739292,20740077,593,20740670
3048,50,50,20747600,20748416,832,20746101,20746891,695,20747586
3049,38,38,20754276,20754892,633,20752911,20753705,567,20754272
3050,42,42,20761352,20762034,699,20759720,20760519,826,20761345
3051,58,58,20768078,20769027,965,20766546,20767333,737,20768070
3052,4,4,20774687,20774737,67,20773355,20774147,534,20774681
3053,2,2,20781746,20781763,33,20780165,20780961,781,20781742
3054,50,50,20788372,20789188,833,20786990,20787775,582,20788357
3055,56,56,20795548,20796464,932,20793800,20794589,946,20795535
3056,52,52,20802207,20803056,866,20800609,20801403,798,20802201
3057,12,12,20808933,20809117,200,20807418,20808217,708,20808925
3058,24,24,20815893,20816275,399,20814244,20815031,846,20815877
3059,10,10,20822718,20822868,167,20821054,20821845,863,20822708
3060,12,12,20829211,20829395,200,20827863,20828659,547,20829206
3061,18,18,20836487,20836770,300,20834689,20835473,998,20836471
3062,6,6,20843163,20843246,100,20841498,20842287,871,20843158
3063,56,56,20849772,20850688,933,20848307,20849101,657,20849758
3064,56,56,20856848,20857764,932,20855117,20855915,928,20856843
3065,54,54,20863274,20864157,900,20861943,20862729,530,20863259
3066,14,14,20870533,20870750,233,20868752,20869543,984,20870527
3067,10,10,20877259,20877409,167,20875561,20876357,886,20877243
3068,44,44,20884069,20884784,732,20882387,20883171,894,20884065
3069,54,54,20890695,20891577,899,20889196,20889985,702,20890687
3070,8,8,20897487,20897604,134,20896006,20896799,674,20897473
3071,52,52,20904546,20905395,866,20902815,20903613,925,20904538
3072,38,38,20911256,20911872,632,20909641,20910427,815,20911242
3073,6,6,20918048,20918132,100,20916450,20917241,800,20918041
3074,54,54,20924575,20925457,899,20923259,20924055,512,20924567
3075,22,22,20931634,20931983,366,20930085,20930869,751,20931620
3076,18,18,20938560,20938843,299,20936895,20937683,872,20938555
3077,26,26,20945036,20945452,433,20943704,20944497,522,20945019
3078,26,26,20952261,20952678,433,20950513,20951311,943,20952254
3079,42,42,20959004,20959687,699,20957339,20958125,871,20958996
3080,32,32,20965830,20966346,533,20964148,20964939,889,20965828
3081,4,4,20972423,20972473,66,20970958,20971753,653,20972406
3082,28,28,20979099,20979548,466,20977784,20978567,519,20979086
3083,48,48,20986291,20987074,799,20984593,20985381,901,20986282
3084,18,18,20993200,20993483,300,20991402,20992195,988,20993183
3085,56,56,20999710,21000626,932,20998212,20999009,695,20999704
3086,50,50,21006469,21007285,833,21005037,21005823,636,21006459
3087,56,56,21013179,21014094,932,21011847,21012637,534,21013171
3088,32,32,21020188,21020704,532,21018656,21019451,719,21020170
3089,6,6,21027247,21027330,100,21025482,21026265,977,21027242
3090,46,46,21034039,21034789,766,21032291,21033079,956,21034035
3091,8,8,21040899,21041015,133,21039101,21039893,993,21040886
3092,56,56,21047358,21048274,933,21045910,21046707,634,21047341
3093,12,12,21054234,21054417,200,21052736,21053521,711,21054232
3094,24,24,21060927,21061310,399,21059545,21060335,584,21060919
3095,44,44,21067803,21068519,732,21066354,21067149,638,21067787
3096,28,28,21074629,21075078,466,21073180,21073963,649,21074612
3097,12,12,21081405,21081588,199,21079990,21080777,619,21081396
3098,10,10,21088514,21088663,166,21086799,21087591,907,21088498
3099,22,22,21095323,21095673,366,21093608,21094405,902,21095307
3100,2,2,21101766,21101783,33,21100434,21101219,539,21101758
3101,18,18,21108675,21108958,300,21107243,21108033,626,21108659
3102,12,12,21115468,21115651,200,21114053,21114847,603,21115450
3103,34,34,21122677,21123226,566,21120879,21121661,997,21122658
3104,40,40,21129103,21129752,666,21127688,21128475,620,21129095
3105,54,54,21136129,21137011,899,21134497,21135289,828,21136117
3106,32,32,21142888,21143404,533,21141306,21142103,770,21142873
3107,16,16,21149897,21150147,267,21148132,21148917,976,21149893
3108,60,60,21156274,21157256,998,21154942,21155731,529,21156260
3109,10,10,21163183,21163333,166,21161751,21162545,623,21163168
3110,42,42,21170059,21170741,699,21168560,21169359,692,21170051
3111,4,4,21176818,21176868,67,21175386,21176173,632,21176805
3112,10,10,21183627,21183777,167,21182195,21182987,623,21183610
3113,20,20,21190387,21190703,333,21189005,21189801,567,21190368
3114,44,44,21197595,21198311,733,21195831,21196615,978,21197593
3115,36,36,21203972,21204555,599,21202640,21203429,530,21203959
3116,18,18,21211214,21211497,300,21209449,21210243,958,21211201
3117,50,50,21217890,21218706,833,21216259,21217057,828,21217885
3118,44,44,21224450,21225166,732,21223084,21223871,569,21224440
3119,28,28,21231492,21231942,466,21229894,21230685,798,21231483
3120,14,14,21238135,21238351,233,21236703,21237499,629,21238128
3121,22,22,21244944,21245294,366,21243529,21244313,613,21244926
3122,50,50,21251687,21252503,832,21250338,21251127,547,21251674
3123,40,40,21258496,21259145,666,21257148,21257941,544,21258485
3124,34,34,21265638,21266188,566,21263957,21264755,867,21265622
3125,20,20,21272514,21272831,333,21270783,21271569,942,21272511
3126,4,4,21279074,21279124,66,21277592,21278383,683,21279066
3127,58,58,21286183,21287132,965,21284401,21285197,974,21286171
3128,40,40,21292842,21293491,666,21291227,21292011,820,21292831
3129,56,56,21299452,21300367,932,21298037,21298825,623,21299448
3130,8,8,21306377,21306494,134,21304846,21305639,734,21306373
3131,18,18,21313120,21313403,300,21311655,21312453,663,21313116
3132,8,8,21320279,21320396,133,21318481,21319267,998,21320265
3133,36,36,21326689,21327272,599,21325290,21326081,600,21326681
3134,22,22,21333548,21333898,366,21332100,21332895,645,21333540
3135,16,16,21340690,21340940,267,21338926,21339709,976,21340685
3136,34,34,21347183,21347733,566,21345735,21346523,645,21347168
3137,2,2,21353959,21353976,34,21352544,21353337,606,21353943
3138,12,12,21360968,21361151,200,21359353,21360151,799,21360950
3139,12,12,21367944,21368127,200,21366179,21366965,961,21367926
3140,60,60,21374770,21375752,999,21372989,21373779,975,21374754
3141,2,2,21381596,21381613,33,21379798,21380593,987,21381580
3142,44,44,21387989,21388705,733,21386624,21387407,565,21387972
3143,42,42,21394865,21395548,699,21393433,21394221,634,21394855
3144,12,12,21401574,21401757,200,21400242,21401035,523,21401558
3145,36,36,21408816,21409399,600,21407052,21407849,950,21408799
3146,14,14,21415376,21415592,233,21413878,21414663,708,21415371
3147,40,40,21422435,21423084,666,21420687,21421477,946,21422423
3148,58,58,21428895,21429844,965,21427496,21428291,589,21428880
3149,44,44,21436004,21436720,732,21434322,21435105,891,21435996
3150,2,2,21442613,21442630,33,21441131,21441919,676,21442595
3151,10,10,21449539,21449689,166,21447941,21448733,803,21449536
3152,20,20,21456432,21456748,332,21454750,21455547,868,21456415
3153,10,10,21463174,21463324,167,21461576,21462361,806,21463167
3154,6,6,21470033,21470117,100,21468385,21469175,852,21470027
3155,16,16,21476909,21477159,267,21475195,21475989,902,21476891
3156,58,58,21483386,21484335,965,21482020,21482803,565,21483368
3157,22,22,21490228,21490578,366,21488830,21489617,595,21490212
3158,12,12,21497004,21497187,200,21495639,21496431,566,21496997
3159,4,4,21503963,21504013,67,21502448,21503245,710,21503955
3160,40,40,21510773,21511422,666,21509274,21510059,710,21510769
3161,54,54,21517399,21518281,899,21516084,21516873,521,21517394
3162,4,4,21524624,21524674,67,21522893,21523687,923,21524610
3163,52,52,21531384,21532233,865,21529702,21530501,870,21531371
3164,58,58,21538193,21539142,966,21536528,21537315,866,21538181
3165,20,20,21545085,21545402,333,21543337,21544129,951,21545080
3166,28,28,21551878,21552328,466,21550147,21550943,931,21551874
3167,14,14,21558704,21558920,233,21556973,21557757,939,21558696
3168,24,24,21565547,21565929,399,21563782,21564571,966,21565537
3169,22,22,21571956,21572306,367,21570591,21571385,558,21571943
3170,18,18,21578932,21579215,300,21577400,21578199,724,21578923
3171,30,30,21585758,21586241,499,21584226,21585013,738,21585751
3172,46,46,21592567,21593316,766,21591036,21591827,738,21592565
3173,14,14,21599360,21599576,233,21597845,21598641,708,21599349
3174,18,18,21606186,21606469,300,21604671,21605455,721,21606176
3175,2,2,21613012,21613028,33,21611480,21612269,727,21612996
3176,54,54,21620071,21620953,899,21618289,21619083,974,21620057
3177,26,26,21626614,21627030,433,21625099,21625897,702,21626599
3178,2,2,21633556,21633573,33,21631925,21632711,838,21633549
3179,32,32,21640166,21640682,532,21638734,21639525,637,21640162
3180,44,44,21646875,21647591,733,21645543,21646339,521,21646860
3181,44,44,21653734,21654450,733,21652369,21653153,578,21653731
3182,10,10,21660677,21660827,166,21659178,21659967,703,21660670
3183,12,12,21667736,21667919,200,21665988,21666781,943,21667724
3184,32,32,21674562,21675078,533,21672797,21673595,952,21674547
3185,16,16,21680922,21681171,266,21679623,21680409,503,21680912
3186,12,12,21687947,21688130,200,21686432,21687223,717,21687940
3187,10,10,21694790,21694940,166,21693241,21694037,738,21694775
3188,22,22,21701366,21701716,366,21700067,21700851,507,21701358
3189,26,26,21708358,21708775,433,21706877,21707665,689,21708354
3190,48,48,21715334,21716117,799,21713686,21714479,841,21715320
3191,32,32,21721844,21722360,533,21720495,21721293,540,21721833
3192,20,20,21728786,21729103,333,21727321,21728107,677,21728784
3193,2,2,21735695,21735712,34,21734130,21734921,765,21735686
3194,46,46,21742521,21743271,766,21740940,21741735,774,21742509
3195,56,56,21749530,21750446,933,21747766,21748549,975,21749524
3196,48,48,21755990,21756773,799,21754575,21755363,610,21755973
3197,12,12,21763032,21763216,200,21761384,21762177,852,21763029
3198,14,14,21769775,21769992,233,21768194,21768991,774,21769765
3199,42,42,21776768,21777450,699,21775020,21775805,953,21776758
3200,16,16,21782511,21782761,267,21781829,21781836,671,21782507
3201,12,12,21789487,21789670,200,21787856,21788650,832,21789482
3202,60,60,21796246,21797229,999,21794682,21795464,767,21796231
3203,46,46,21803106,21803855,766,21801491,21802278,810,21803088
3204,2,2,21809982,21809998,33,21808300,21809092,872,21809964
3205,16,16,21816907,21817157,267,21815109,21815906,996,21816902
3206,28,28,21823334,21823783,466,21821935,21822720,597,21823317
3207,20,20,21830376,21830692,333,21828745,21829534,833,21830367
3208,22,22,21836969,21837319,366,21835554,21836348,610,21836958
3209,54,54,21844061,21844944,899,21842363,21843162,882,21844044
3210,52,52,21850687,21851537,866,21849189,21849976,696,21850672
3211,36,36,21857497,21858079,599,21855998,21856790,699,21857489
3212,2,2,21864489,21864506,34,21862808,21863604,881,21864485
3213,10,10,21871149,21871298,166,21869634,21870418,720,21871138
3214,44,44,21877891,21878607,733,21876443,21877232,656,21877888
3215,34,34,21884834,21885383,566,21883252,21884046,785,21884831
3216,44,44,21891793,21892509,732,21890061,21890860,920,21891780
3217,28,28,21898536,21898985,466,21896887,21897674,849,21898523
3218,28,28,21905445,21905894,466,21903697,21904488,942,21905430
3219,6,6,21912071,21912154,100,21910506,21911302,766,21912068
3220,12,12,21918680,21918864,200,21917332,21918116,558,21918674
3221,24,24,21925523,21925906,400,21924141,21924930,576,21925506
3222,52,52,21932699,21933548,865,21930950,21931744,940,21932684
3223,50,50,21939341,21940157,833,21937760,21938558,780,21939338
3224,12,12,21946367,21946550,200,21944586,21945372,989,21946361
3225,24,24,21953126,21953509,400,21951395,21952186,935,21953121
3226,14,14,21959703,21959919,233,21958204,21959000,694,21959694
3227,34,34,21966678,21967228,566,21965030,21965814,852,21966666
3228,54,54,21973604,21974487,899,21971839,21972628,973,21973601
3229,22,22,21980364,21980713,366,21978649,21979442,919,21980361
3230,38,38,21987173,21987789,633,21985458,21986256,909,21987165
3231,44,44,21993999,21994715,732,21992284,21993070,912,21993982
3232,34,34,22000758,22001308,566,21999093,21999884,868,22000752
3233,58,58,22007234,22008183,966,22005903,22006698,520,22007218
3234,40,40,22014060,22014710,666,22012729,22013512,538,22014050
3235,8,8,22021286,22021402,133,22019538,22020326,949,22021275
3236,4,4,22027862,22027912,67,22026347,22027140,705,22027845
3237,30,30,22034721,22035204,500,22033156,22033954,763,22034717
3238,24,24,22041431,22041814,399,22039982,22040768,647,22041415
3239,54,54,22048257,22049139,899,22046792,22047582,658,22048240
3240,4,4,22054467,22054517,66,22053601,22053613,849,22054462
3241,44,44,22061376,22062092,732,22059644,22060427,945,22061372
3242,32,32,22068035,22068551,533,22066454,22067241,776,22068017
3243,20,20,22074578,22074894,333,22073263,22074055,514,22074569
3244,26,26,22081537,22081953,433,22080072,22080869,663,22081532
3245,8,8,22088580,22088696,133,22086898,22087683,879,22088562
3246,18,18,22095505,22095788,300,22093707,22094497,993,22095490
3247,16,16,22102265,22102515,266,22100517,22101311,950,22102261
3248,44,44,22109057,22109773,733,22107343,22108125,930,22109055
3249,54,54,22115484,22116366,899,22114152,22114939,542,22115481
3250,6,6,22122593,22122676,100,22120961,22121753,822,22122575
3251,22,22,22129369,22129718,366,22127770,22128567,799,22129366
3252,28,28,22136245,22136694,466,22134596,22135381,854,22136235
3253,20,20,22142887,22143204,333,22141406,22142195,689,22142884
3254,16,16,22149530,22149780,267,22148215,22149009,503,22149512
3255,52,52,22156656,22157505,866,22155024,22155823,828,22156651
3256,2,2,22163465,22163482,33,22161850,22162637,817,22163454
3257,44,44,22170208,22170924,732,22168659,22169451,749,22170200
3258,4,4,22177000,22177050,67,22175469,22176265,731,22176996
3259,48,48,22183843,22184625,799,22182295,22183079,746,22183825
3260,16,16,22190403,22190652,266,22189104,22189893,503,22190396
3261,4,4,22197312,22197362,66,22195913,22196707,598,22197305
3262,22,22,22204471,22204820,366,22202723,22203521,938,22204459
3263,2,2,22211297,22211313,33,22209548,22210335,943,22211278
3264,30,30,22217740,22218222,499,22216358,22217149,577,22217726
3265,50,50,22224699,22225515,832,22223167,22223963,719,22224682
3266,56,56,22231558,22232474,932,22229993,22230777,768,22231545
3267,6,6,22238500,22238584,100,22236802,22237591,899,22238490
3268,42,42,22245393,22246076,699,22243612,22244405,977,22245382
3269,40,40,22252086,22252735,666,22250421,22251219,857,22252076
3270,16,16,22258562,22258812,266,22257247,22258033,518,22258551
3271,10,10,22265571,22265721,167,22264056,22264847,720,22265567
3272,46,46,22272330,22273080,766,22270865,22271661,653,22272314
3273,50,50,22279290,22280105,832,22277691,22278475,805,22279280
3274,26,26,22285882,22286299,433,22284501,22285289,582,22285871
3275,40,40,22293008,22293657,666,22291310,22292103,901,22293004
3276,40,40,22299684,22300333,666,22298119,22298917,759,22299676
3277,2,2,22306560,22306577,33,22304945,22305731,816,22306547
3278,12,12,22313536,22313719,200,22311754,22312545,987,22313532
3279,26,26,22319962,22320378,433,22318564,22319359,596,22319955
3280,60,60,22327088,22328070,999,22325390,22326173,909,22327082
3281,60,60,22333714,22334696,999,22332199,22332987,715,22333702
3282,4,4,22340373,22340423,67,22339008,22339801,566,22340367
3283,8,8,22347482,22347599,134,22345817,22346615,863,22347478
3284,14,14,22354408,22354625,233,22352643,22353429,977,22354406
3285,24,24,22360884,22361267,400,22359453,22360243,626,22360869
3286,34,34,22367960,22368510,566,22366262,22367057,896,22367953
3287,50,50,22374386,22375202,833,22373088,22373871,508,22374379
3288,50,50,22381479,22382295,832,22379897,22380685,779,22381464
3289,28,28,22388188,22388638,466,22386706,22387499,671,22388170
3290,26,26,22395197,22395613,433,22393516,22394313,879,22395192
3291,18,18,22401757,22402040,299,22400342,22401127,627,22401754
3292,38,38,22408783,22409399,632,22407151,22407941,825,22408766
3293,24,24,22415725,22416108,400,22413960,22414755,968,22415723
3294,18,18,22422201,22422484,300,22420786,22421569,622,22422191
3295,56,56,22428927,22429843,933,22427595,22428383,529,22428912
3296,12,12,22436070,22436253,199,22434405,22435197,858,22436055
3297,32,32,22442746,22443262,532,22441214,22442011,722,22442733
3298,24,24,22449622,22450005,399,22448040,22448825,788,22449613
3299,20,20,22456298,22456614,333,22454849,22455639,653,22456292
3300,52,52,22462391,22463240,866,22461659,22461670,706,22462376
3301,24,24,22469051,22469433,399,22467685,22468484,550,22469034
3302,10,10,22475827,22475976,166,22474511,22475298,510,22475808
3303,26,26,22482686,22483102,433,22481321,22482112,567,22482679
3304,28,28,22489845,22490294,466,22488130,22488926,916,22489842
3305,60,60,22496471,22497453,999,22494956,22495740,719,22496459
3306,10,10,22503430,22503580,166,22501765,22502554,859,22503413
3307,56,56,22510239,22511155,933,22508574,22509368,867,22510235
3308,16,16,22516882,22517132,266,22515384,22516182,695,22516877
3309,40,40,22523841,22524490,666,22522210,22522996,837,22523833
3310,14,14,22530451,22530667,233,22529019,22529810,637,22530447
3311,54,54,22537160,22538042,899,22535828,22536624,524,22537148
3312,4,4,22544003,22544053,66,22542654,22543438,552,22543990
3313,46,46,22550845,22551594,766,22549463,22550252,579,22550831
3314,30,30,22557821,22558304,499,22556273,22557066,741,22557807
3315,50,50,22564464,22565280,832,22563082,22563880,576,22564456
3316,42,42,22571573,22572255,699,22569908,22570694,870,22571564
3317,24,24,22578332,22578715,400,22576717,22577508,818,22578326
3318,50,50,22585258,22586074,832,22583526,22584322,922,22585244
3319,20,20,22590968,22591285,333,22590352,22590353,601,22590954
3320,30,30,22597894,22598377,500,22596379,22597167,721,22597888
3321,8,8,22604687,22604803,133,22603188,22603981,696,22604677
3322,6,6,22611346,22611430,100,22609998,22610795,537,22611332
3323,40,40,22618455,22619105,666,22616824,22617609,832,22618441
3324,56,56,22625048,22625964,932,22623633,22624423,612,22625035
3325,22,22,22632007,22632357,367,22630442,22631237,760,22631997
3326,48,48,22638783,22639566,799,22637268,22638051,727,22638778
3327,46,46,22645726,22646475,766,22644077,22644865,853,22645718
3328,48,48,22652219,22653001,799,22650887,22651679,534,22652213
3329,46,46,22659228,22659977,766,22657696,22658493,721,22659214
3330,44,44,22665871,22666586,732,22664522,22665307,555,22665862
3331,48,48,22672647,22673429,799,22671331,22672121,522,22672643
3332,26,26,22679789,22680205,433,22678141,22678935,838,22679773
3333,34,34,22686315,22686864,566,22684966,22685749,548,22686297
3334,58,58,22693557,22694506,966,22691776,22692563,984,22693547
3335,22,22,22700250,22700600,366,22698585,22699377,861,22700238
3336,4,4,22707092,22707142,67,22705394,22706191,897,22707088
3337,28,28,22713619,22714068,466,22712220,22713005,607,22713612
3338,22,22,22720744,22721094,367,22719030,22719819,923,22720742
3339,42,42,22727187,22727870,700,22725839,22726633,549,22727182
3340,18,18,22734346,22734629,300,22732648,22733447,887,22734334
3341,32,32,22741239,22741755,533,22739474,22740261,967,22741228
3342,34,34,22747882,22748431,566,22746283,22747075,799,22747874
3343,10,10,22754774,22754924,167,22753093,22753889,869,22754758
3344,58,58,22761550,22762499,966,22759919,22760703,845,22761548
3345,36,36,22768026,22768609,600,22766728,22767517,505,22768022
3346,18,18,22775185,22775468,300,22773537,22774331,852,22775183
3347,30,30,22781895,22782378,499,22780346,22781145,733,22781878
3348,60,60,22788821,22789803,999,22787172,22787959,857,22788816
3349,56,56,22795380,22796296,932,22793982,22794773,599,22795372
3350,34,34,22802489,22803038,566,22800791,22801587,895,22802482
3351,8,8,22809132,22809248,133,22807617,22808401,714,22809115
3352,38,38,22815741,22816357,633,22814426,22815215,514,22815729
3353,58,58,22822900,22823849,966,22821235,22822029,860,22822889
3354,56,56,22829743,22830659,932,22828045,22828843,884,22829727
3355,12,12,22836219,22836402,200,22834871,22835657,554,22836211
3356,58,58,22843095,22844044,966,22841680,22842471,615,22843086
3357,58,58,22850204,22851153,966,22848489,22849285,910,22850195
3358,34,34,22856647,22857196,566,22855315,22856099,534,22856633
3359,6,6,22863456,22863540,100,22862124,22862913,538,22863451
3360,8,8,22870399,22870515,133,22868934,22869727,661,22870388
3361,34,34,22877108,22877658,566,22875743,22876541,561,22877102
3362,52,52,22884134,22884983,866,22882569,22883355,771,22884126
3363,8,8,22891126,22891243,134,22889378,22890169,943,22891112
3364,20,20,22897986,22898302,333,22896188,22896983,988,22897971
3365,36,36,22904578,22905161,600,22903013,22903797,769,22904566
3366,48,48,22911304,22912087,800,22909823,22910611,683,22911294
3367,56,56,22918380,22919296,932,22916632,22917425,939,22918364
3368,40,40,22925006,22925656,666,22923441,22924239,752,22924991
3369,14,14,22931816,22932032,233,22930267,22931053,759,22931812
3370,4,4,22938658,22938708,67,22937077,22937867,784,22938651
3371,4,4,22945384,22945434,67,22943886,22944681,688,22945369
3372,42,42,22952410,22953093,699,22950712,22951495,907,22952402
3373,48,48,22958936,22959719,799,22957521,22958309,609,22958918
3374,6,6,22965979,22966062,99,22964330,22965123,838,22965961
3375,60,60,22972472,22973454,998,22971140,22971937,529,22972466
3376,18,18,22979347,22979630,300,22977966,22978751,582,22979333
3377,48,48,22986290,22987072,799,22984775,22985565,720,22986285
3378,60,60,22993249,22994231,999,22991584,22992379,862,22993241
3379,26,26,22999725,23000142,433,22998410,22999193,522,22999715
3380,46,46,23006818,23007567,765,23005219,23006007,805,23006812
3381,46,46,23013444,23014193,766,23012029,23012821,618,23013439
3382,34,34,23020586,23021135,566,23018838,23019635,945,23020580
3383,14,14,23027146,23027362,233,23025664,23026449,691,23027140
3384,6,6,23034255,23034338,99,23032473,23033263,973,23034236
3385,56,56,23040914,23041830,932,23039282,23040077,832,23040909
3386,2,2,23047623,23047640,34,23046108,23046891,718,23047609
3387,8,8,23054499,23054616,133,23052918,23053705,785,23054490
3388,12,12,23061458,23061642,200,23059727,23060519,934,23061453
3389,32,32,23068251,23068767,533,23066536,23067333,903,23068236
3390,24,24,23074727,23075110,400,23073362,23074147,578,23074725
3391,32,32,23081786,23082302,533,23080171,23080961,812,23081773
3392,2,2,23088646,23088662,33,23086981,23087775,864,23088639
3393,52,52,23095205,23096054,866,23093790,23094589,599,23095188
3394,44,44,23102198,23102913,732,23100616,23101403,784,23102187
3395,6,6,23108757,23108840,100,23107425,23108217,535,23108752
3396,12,12,23115883,23116066,200,23114235,23115031,841,23115872
3397,30,30,23122675,23123158,500,23121060,23121845,828,23122673
3398,48,48,23129435,23130217,799,23127870,23128659,764,23129423
3399,24,24,23136144,23136527,400,23134679,23135473,654,23136127
3400,16,16,23142987,23143236,266,23141488,23142287,696,23142983
3401,18,18,23149813,23150096,299,23148314,23149101,698,23149799
3402,56,56,23156472,23157388,932,23155124,23155915,549,23156464
3403,48,48,23163464,23164247,800,23161933,23162729,731,23163460
3404,42,42,23170407,23171090,699,23168759,23169543,861,23170404
3405,2,2,23177116,23177133,34,23175568,23176357,743,23177100
3406,18,18,23184026,23184309,299,23182377,23183171,843,23184014
3407,12,12,23190968,23191151,200,23189187,23189985,977,23190962
3408,22,22,23197694,23198044,366,23196013,23196799,893,23197692
3409,8,8,23204120,23204237,134,23202822,23203613,501,23204114
3410,48,48,23211329,23212112,799,23209631,23210427,891,23211318
3411,46,46,23218155,23218904,766,23216457,23217241,906,23218147
3412,38,38,23224815,23225431,632,23223266,23224055,742,23224797
3413,28,28,23231507,23231957,467,23230076,23230869,630,23231499
3414,16,16,23238450,23238700,266,23236885,23237683,761,23238444
3415,46,46,23245459,23246208,766,23243711,23244497,949,23245446
3416,32,32,23252168,23252684,533,23250520,23251311,841,23252152
3417,4,4,23258711,23258761,67,23257329,23258125,582,23258707
3418,38,38,23265870,23266486,633,23264155,23264939,923,23265862
3419,42,42,23272280,23272962,699,23270965,23271753,522,23272275
3420,48,48,23279289,23280071,799,23277774,23278567,717,23279284
3421,22,22,23285932,23286281,366,23284583,23285381,540,23285921
3422,36,36,23293091,23293673,599,23291409,23292195,883,23293078
3423,56,56,23299733,23300649,933,23298218,23299009,710,23299719
3424,36,36,23306393,23306976,599,23305028,23305823,552,23306375
3425,26,26,23313202,23313618,433,23311854,23312637,554,23313191
3426,34,34,23320278,23320827,566,23318663,23319451,817,23320268
3427,38,38,23326871,23327487,632,23325472,23326265,589,23326854
3428,24,24,23333697,23334080,399,23332281,23333079,614,23333693
3429,6,6,23340872,23340955,100,23339107,23339893,966,23340859
3430,58,58,23347582,23348531,965,23345917,23346707,871,23347578
3431,46,46,23354208,23354957,766,23352726,23353521,681,23354202
3432,42,42,23360900,23361583,700,23359552,23360335,559,23360894
3433,18,18,23368076,23368359,300,23366361,23367149,924,23368073
3434,58,58,23374769,23375718,965,23373170,23373963,790,23374753
3435,4,4,23381362,23381412,66,23379980,23380777,566,23381343
3436,6,6,23388504,23388587,100,23386806,23387591,901,23388492
3437,16,16,23394964,23395213,266,23393615,23394405,543,23394948
3438,16,16,23401939,23402189,267,23400424,23401219,712,23401931
3439,8,8,23408599,23408715,133,23407250,23408033,549,23408582
3440,60,60,23415425,23416407,999,23414060,23414847,561,23415408
3441,34,34,23422184,23422733,566,23420869,23421661,507,23422168
3442,18,18,23429043,23429326,300,23427678,23428475,551,23429026
3443,10,10,23436269,23436419,166,23434504,23435289,976,23436265
3444,20,20,23443028,23443344,333,23441313,23442103,908,23443011
3445,8,8,23449871,23449987,133,23448123,23448917,945,23449862
3446,24,24,23456314,23456697,399,23454949,23455731,565,23456296
3447,46,46,23463106,23463856,766,23461758,23462545,546,23463091
3448,36,36,23469916,23470498,599,23468567,23469359,539,23469898
3449,26,26,23476908,23477324,433,23475376,23476173,732,23476905
3450,60,60,23483801,23484783,999,23482202,23482987,801,23483788
3451,50,50,23490693,23491509,833,23489012,23489801,886,23490687
3452,6,6,23497303,23497386,100,23495821,23496615,671,23497286
3453,20,20,23504312,23504628,333,23502630,23503429,875,23504304
3454,2,2,23510921,23510938,33,23509456,23510243,668,23510911
3455,4,4,23517581,23517631,66,23516265,23517057,514,23517571
3456,6,6,23524806,23524889,100,23523075,23523871,919,23524790
3457,16,16,23531516,23531765,266,23529901,23530685,825,23531510
3458,12,12,23538025,23538208,200,23536710,23537499,522,23538021
3459,40,40,23545251,23545900,666,23543519,23544313,920,23545233
3460,52,52,23551827,23552676,866,23550328,23551127,686,23551813
3461,42,42,23558902,23559585,700,23557154,23557941,955,23558896
3462,4,4,23565745,23565795,67,23563964,23564755,983,23565738
3463,56,56,23572221,23573137,933,23570773,23571569,649,23572218
3464,36,36,23579347,23579930,599,23577599,23578383,958,23579341
3465,40,40,23585973,23586622,666,23584408,23585197,762,23585959
3466,18,18,23592849,23593132,300,23591217,23592011,822,23592833
3467,40,40,23599625,23600274,666,23598027,23598825,788,23599613
3468,18,18,23606601,23606884,299,23604853,23605639,953,23606592
3469,24,24,23613377,23613760,399,23611662,23612453,906,23613359
3470,18,18,23620136,23620419,300,23618471,23619267,867,23620134
3471,52,52,23626945,23627794,866,23625297,23626081,846,23626927
3472,26,26,23633472,23633888,433,23632106,23632895,571,23633466
3473,6,6,23640431,23640514,100,23638916,23639709,707,23640416
3474,22,22,23647423,23647773,366,23645725,23646523,891,23647414
3475,34,34,23654199,23654749,566,23652551,23653337,860,23654197
3476,24,24,23660909,23661292,399,23659360,23660151,749,23660900
3477,12,12,23667601,23667784,200,23666170,23666965,626,23667591
3478,32,32,23674744,23675260,532,23672995,23673779,947,23674726
3479,18,18,23681137,23681420,299,23679805,23680593,541,23681134
3480,34,34,23688395,23688945,567,23686614,23687407,983,23688390
3481,8,8,23695072,23695188,133,23693423,23694221,837,23695058
3482,26,26,23701781,23702197,433,23700249,23701035,737,23701772
3483,24,24,23708624,23709006,399,23707059,23707849,756,23708605
3484,46,46,23715316,23716065,766,23713868,23714663,649,23715312
3485,10,10,23722409,23722558,166,23720694,23721477,913,23722390
3486,50,50,23729251,23730067,833,23727503,23728291,942,23729233
3487,32,32,23735861,23736377,532,23734312,23735105,744,23735849
3488,50,50,23742503,23743319,833,23741122,23741919,566,23742485
3489,22,22,23749413,23749762,366,23747948,23748733,671,23749404
3490,56,56,23756189,23757104,932,23754757,23755547,630,23756177
3491,56,56,23763264,23764180,933,23761566,23762361,886,23763247
3492,16,16,23769857,23770107,267,23768392,23769175,680,23769855
3493,14,14,23776716,23776933,233,23775201,23775989,709,23776698
3494,6,6,23783476,23783559,100,23782011,23782803,660,23783463
3495,12,12,23790268,23790452,200,23788820,23789617,634,23790251
3496,54,54,23796961,23797843,899,23795646,23796431,523,23796954
3497,42,42,23803837,23804520,699,23802455,23803245,574,23803819
3498,28,28,23810713,23811162,466,23809264,23810059,644,23810703
3499,26,26,23817506,23817922,432,23816090,23816873,619,23817492
3500,30,30,23824498,23824981,499,23822900,23823687,806,23824493
3501,48,48,23831124,23831907,799,23829709,23830501,613,23831114
3502,42,42,23838033,23838716,700,23836518,23837315,714,23838029
3503,54,54,23844826,23845708,899,23843344,23844129,683,23844812
3504,12,12,23851552,23851735,200,23850153,23850943,597,23851540
3505,2,2,23858478,23858494,33,23856963,23857757,715,23858472
3506,56,56,23865320,23866236,933,23863772,23864571,740,23865311
3507,54,54,23872163,23873045,899,23870598,23871385,762,23872147
3508,10,10,23878889,23879039,166,23877407,23878199,674,23878873
3509,12,12,23885715,23885898,200,23884217,23885013,694,23885707
3510,38,38,23892674,23893290,633,23891042,23891827,830,23892657
3511,38,38,23899433,23900049,633,23897852,23898641,784,23899425
3512,24,24,23906459,23906842,400,23904661,23905455,995,23906450
3513,14,14,23913085,23913302,233,23911470,23912269,807,23913076
3514,40,40,23919994,23920644,666,23918296,23919083,897,23919980
3515,54,54,23926837,23927719,899,23925106,23925897,938,23926835
3516,8,8,23933347,23933463,133,23931915,23932711,624,23933335
3517,24,24,23940256,23940639,399,23938741,23939525,728,23940253
3518,16,16,23947032,23947282,266,23945550,23946339,689,23947028
3519,30,30,23954124,23954607,500,23952359,23953153,957,23954110
3520,8,8,23960700,23960817,134,23959169,23959967,716,23960683
3521,48,48,23967759,23968542,799,23965995,23966781,969,23967750
3522,26,26,23974452,23974868,433,23972804,23973595,844,23974439
3523,54,54,23980962,23981844,899,23979613,23980409,541,23980950
3524,40,40,23987871,23988520,666,23986439,23987223,638,23987861
3525,8,8,23994663,23994780,134,23993248,23994037,612,23994649
3526,38,38,24000857,24001473,632,24000058,24000068,779,24000847
3527,28,28,24007400,24007849,466,24006084,24006882,509,24007391
3528,10,10,24014475,24014625,167,24012910,24013696,767,24014463
3529,36,36,24021168,24021751,599,24019720,24020510,640,24021150
3530,24,24,24028260,24028643,400,24026529,24027324,920,24028244
3531,6,6,24034703,24034787,100,24033355,24034138,547,24034685
3532,56,56,24041679,24042595,933,24040164,24040952,713,24041665
3533,30,30,24048738,24049221,500,24046973,24047766,967,24048733
3534,30,30,24055165,24055647,499,24053783,24054580,577,24055157
3535,52,52,24062090,24062939,866,24060609,24061394,678,24062072
3536,54,54,24068783,24069666,899,24067418,24068208,567,24068775
3537,44,44,24075576,24076292,732,24074227,24075022,539,24075561
3538,48,48,24082651,24083434,800,24081053,24081836,797,24082633
3539,22,22,24089511,24089860,366,24087862,24088650,850,24089500
3540,4,4,24096104,24096153,66,24094672,24095464,629,24096093
3541,60,60,24103196,24104178,999,24101481,24102278,914,24103192
3542,8,8,24109622,24109739,133,24108307,24109092,517,24109609
3543,42,42,24116531,24117214,700,24115116,24115906,618,24116524
3544,48,48,24123724,24124506,799,24121926,24122720,997,24123717
3545,8,8,24130167,24130283,133,24128751,24129534,617,24130151
3546,36,36,24136959,24137542,600,24135561,24136348,606,24136954
3547,22,22,24144101,24144451,367,24142370,24143162,930,24144092
3548,52,52,24150861,24151710,866,24149179,24149976,876,24150852
3549,26,26,24157387,24157803,433,24156005,24156790,581,24157371
3550,12,12,24164429,24164613,200,24162815,24163604,822,24164426
3551,30,30,24171122,24171605,500,24169624,24170418,687,24171105
3552,12,12,24177898,24178081,200,24176433,24177232,659,24177891
3553,20,20,24184957,24185274,333,24183259,24184046,905,24184951
3554,28,28,24191500,24191950,466,24190068,24190860,623,24191483
3555,8,8,24198259,24198376,134,24196878,24197674,579,24198253
3556,12,12,24205269,24205452,199,24203704,24204488,769,24205257
3557,42,42,24212261,24212944,699,24210513,24211302,948,24212250
3558,28,28,24219120,24219570,466,24217322,24218116,995,24219111
3559,18,18,24225596,24225880,300,24224131,24224930,661,24225591
3560,14,14,24232722,24232939,233,24230957,24231744,976,24232720
3561,44,44,24239065,24239781,733,24237767,24238558,502,24239060
3562,12,12,24246224,24246407,200,24244576,24245372,835,24246207
3563,12,12,24252767,24252950,200,24251402,24252186,577,24252763
3564,14,14,24259626,24259843,233,24258211,24259000,624,24259624
3565,18,18,24266469,24266752,300,24265020,24265814,645,24266459
3566,54,54,24273361,24274244,899,24271830,24272628,722,24273350
3567,10,10,24280154,24280304,167,24278656,24279442,702,24280144
3568,32,32,24287063,24287579,533,24285465,24286256,795,24287051
3569,20,20,24293856,24294172,333,24292274,24293070,777,24293847
3570,30,30,24300582,24301065,499,24299100,24299884,689,24300573
3571,34,34,24307591,24308140,566,24305909,24306698,883,24307581
3572,52,52,24314117,24314966,866,24312719,24313512,595,24314107
3573,34,34,24320910,24321459,566,24319528,24320326,573,24320899
3574,2,2,24327902,24327919,34,24326354,24327140,753,24327893
3575,48,48,24334845,24335627,799,24333163,24333954,878,24334832
3576,60,60,24341288,24342270,999,24339973,24340768,508,24341276
3577,36,36,24348447,24349029,599,24346798,24347582,850,24348432
3578,32,32,24355040,24355556,532,24353608,24354396,632,24355028
3579,22,22,24361999,24362348,366,24360417,24361210,776,24361986
3580,38,38,24368941,24369557,633,24367226,24368024,907,24368931
3581,16,16,24375584,24375834,266,24374052,24374838,732,24375570
3582,38,38,24382493,24383109,633,24380862,24381652,824,24382476
3583,38,38,24389236,24389852,632,24387671,24388466,759,24389225
3584,50,50,24395812,24396628,832,24394497,24395280,517,24395797
3585,30,30,24403004,24403487,500,24401306,24402094,908,24403002
3586,30,30,24409813,24410296,500,24408115,24408908,889,24409797
3587,60,60,24416356,24417339,999,24414925,24415722,627,24416349
3588,42,42,24423399,24424081,699,24421751,24422536,847,24423383
3589,54,54,24430341,24431224,899,24428560,24429350,985,24430335
3590,20,20,24437167,24437483,333,24435369,24436164,995,24437159
3591,48,48,24443960,24444742,799,24442195,24442978,977,24443955
3592,24,24,24450669,24451052,400,24449004,24449792,859,24450651
3593,32,32,24457179,24457695,533,24455814,24456606,556,24457162
3594,22,22,24464138,24464488,366,24462623,24463420,704,24464124
3595,46,46,24471097,24471846,766,24469449,24470234,847,24471081
3596,36,36,24477723,24478306,600,24476258,24477048,668,24477716
3597,14,14,24484816,24485032,233,24483067,24483862,948,24484810
3598,32,32,24491425,24491941,533,24489893,24490676,742,24491418
3599,54,54,24498334,24499217,899,24496703,24497490,829,24498319
3600,22,22,24505293,24505643,367,24503512,24504304,986,24505290
3601,12,12,24511636,24511820,200,24510321,24511118,514,24511632
3602,50,50,24518729,24519545,832,24517147,24517932,782,24518714
3603,50,50,24525421,24526237,833,24523956,24524746,672,24525418
3604,18,18,24532364,24532647,300,24530766,24531560,795,24532355
3605,44,44,24538973,24539689,733,24537575,24538374,588,24538962
3606,24,24,24546166,24546549,399,24544401,24545188,961,24546149
3607,46,46,24553008,24553757,766,24551210,24552002,989,24552991
3608,4,4,24559385,24559435,66,24558019,24558816,553,24559369
3609,8,8,24566327,24566444,133,24564845,24565630,694,24566324
3610,20,20,24573186,24573503,333,24571655,24572444,739,24573183
3611,52,52,24580212,24581061,866,24578464,24579258,938,24580196
3612,18,18,24586772,24587055,299,24585273,24586072,690,24586762
3613,36,36,24593781,24594363,599,24592099,24592886,887,24593773
3614,10,10,24600240,24600390,167,24598908,24599700,533,24600233
3615,4,4,24607166,24607216,67,24605718,24606514,645,24607159
3616,14,14,24614059,24614275,233,24612544,24613328,724,24614052
3617,54,54,24620818,24621700,899,24619353,24620142,664,24620806
3618,36,36,24627627,24628210,600,24626162,24626956,663,24627619
3619,30,30,24634570,24635053,499,24632972,24633770,787,24634557
3620,10,10,24641263,24641412,166,24639798,24640584,672,24641256
3621,50,50,24647972,24648788,832,24646607,24647398,563,24647961
3622,58,58,24655148,24656097,965,24653416,24654212,918,24655130
3623,24,24,24661840,24662223,400,24660242,24661026,797,24661823
3624,22,22,24668383,24668733,366,24667051,24667840,539,24668379
3625,40,40,24675409,24676058,666,24673861,24674654,745,24675399
3626,32,32,24682401,24682917,533,24680670,24681468,928,24682396
3627,34,34,24689244,24689793,566,24687496,24688282,957,24689239
3628,22,22,24695920,24696270,366,24694305,24695096,810,24695906
3629,18,18,24702546,24702829,300,24701114,24701910,626,24702536
3630,16,16,24709622,24709872,266,24707940,24708724,892,24709616
3631,44,44,24716248,24716964,733,24714750,24715538,692,24716230
3632,28,28,24723091,24723540,466,24721559,24722352,735,24723087
3633,12,12,24730050,24730233,199,24728368,24729166,866,24730032
3634,40,40,24736692,24737342,666,24735194,24735980,695,24736675
3635,28,28,24743485,24743935,466,24742003,24742794,679,24743473
3636,28,28,24750461,24750910,466,24748813,24749608,848,24750456
3637,20,20,24757270,24757586,333,24755639,24756422,843,24757265
3638,58,58,24764030,24764978,965,24762448,24763236,776,24764012
3639,18,18,24770839,24771122,299,24769257,24770050,778,24770828
3640,12,12,24777548,24777731,200,24776066,24776864,667,24777531
3641,38,38,24784457,24785073,633,24782892,24783678,763,24784441
3642,36,36,24791150,24791733,599,24789702,24790492,656,24791148
3643,40,40,24797926,24798575,666,24796511,24797306,615,24797921
3644,58,58,24804852,24805801,966,24803337,24804120,728,24804848
3645,60,60,24811661,24812643,999,24810146,24810934,723,24811657
3646,16,16,24818587,24818837,266,24816955,24817748,832,24818580
3647,42,42,24825313,24825996,699,24823765,24824562,745,24825307
3648,40,40,24832256,24832905,666,24830591,24831376,877,24832253
3649,32,32,24839032,24839548,532,24837400,24838190,829,24839019
3650,10,10,24845624,24845774,167,24844209,24845004,604,24845608
3651,60,60,24852484,24853466,999,24851035,24851818,655,24852473
3652,18,18,24859459,24859742,300,24857844,24858632,822,24859454
3653,8,8,24866319,24866435,133,24864654,24865446,864,24866310
3654,2,2,24873161,24873178,34,24871463,24872260,892,24873152
3655,50,50,24879771,24880587,832,24878289,24879074,683,24879757
3656,6,6,24886796,24886880,100,24885098,24885888,904,24886792
3657,30,30,24893239,24893722,500,24891908,24892702,535,24893237
3658,18,18,24900249,24900532,299,24898734,24899516,730,24900246
3659,48,48,24907025,24907807,799,24905543,24906330,680,24907010
3660,44,44,24913801,24914516,732,24912352,24913144,639,24913783
3661,30,30,24920610,24921093,499,24919161,24919958,644,24920602
3662,38,38,24927636,24928252,632,24925987,24926772,845,24927617
3663,60,60,24934278,24935261,999,24932797,24933586,683,24934269
3664,56,56,24940954,24941870,933,24939606,24940400,544,24940944
3665,60,60,24947780,24948763,999,24946415,24947214,562,24947776
3666,18,18,24955022,24955306,300,24953241,24954028,988,24955016
3667,56,56,24961782,24962697,932,24960050,24960842,935,24961777
3668,54,54,24968408,24969290,899,24966860,24967656,746,24968402
3669,38,38,24975284,24975900,633,24973686,24974470,797,24975267
3670,20,20,24981860,24982176,333,24980495,24981284,571,24981855
3671,8,8,24988902,24989019,134,24987304,24988098,786,24988884
3672,58,58,24995778,24996727,966,24994113,24994912,855,24995767
3673,38,38,25002355,25002971,632,25000939,25001726,620,25002346
3674,16,16,25009347,25009597,266,25007749,25008540,798,25009338
3675,34,34,25016140,25016689,566,25014558,25015354,772,25016126
3676,60,60,25022899,25023881,999,25021384,25022168,726,25022894
3677,42,42,25029209,25029891,699,25028193,25028199,996,25029195
3678,40,40,25035901,25036551,666,25034220,25035013,881,25035894
3679,58,58,25042428,25043377,965,25041029,25041827,591,25042418
3680,2,2,25049420,25049437,33,25047855,25048641,767,25049408
3681,20,20,25056363,25056679,333,25054664,25055455,905,25056360
3682,14,14,25063105,25063322,233,25061474,25062269,830,25063099
3683,46,46,25069981,25070730,766,25068300,25069083,893,25069976
3684,52,52,25076757,25077606,866,25075109,25075897,849,25076746
3685,16,16,25083716,25083966,267,25081918,25082711,990,25083701
3686,22,22,25090359,25090709,366,25088728,25089525,831,25090356
3687,10,10,25097035,25097185,167,25095553,25096339,691,25097030
3688,16,16,25103861,25104111,267,25102363,25103153,700,25103853
3689,34,34,25110904,25111453,566,25109172,25109967,930,25110897
3690,32,32,25117680,25118196,532,25115998,25116781,887,25117668
3691,18,18,25124406,25124689,299,25122807,25123595,793,25124388
3692,36,36,25130932,25131515,599,25129617,25130409,511,25130920
3693,12,12,25138191,25138374,199,25136426,25137223,953,25138176
3694,34,34,25144950,25145499,566,25143252,25144037,909,25144946
3695,16,16,25151576,25151826,266,25150061,25150851,723,25151574
3696,44,44,25158219,25158935,732,25156870,25157665,545,25158210
3697,38,38,25165228,25165844,633,25163696,25164479,738,25165217
3698,56,56,25172170,25173086,933,25170506,25171293,863,25172156
3699,6,6,25178980,25179063,100,25177315,25178107,863,25178970
3700,24,24,25185539,25185922,400,25184124,25184921,615,25185536
3701,6,6,25192432,25192515,100,25190950,25191735,690,25192425
3702,20,20,25198675,25198991,333,25197759,25197766,893,25198659
3703,24,24,25205135,25205518,399,25203786,25204580,549,25205129
3704,4,4,25211994,25212044,67,25210595,25211394,587,25211981
3705,6,6,25218770,25218853,100,25217421,25218208,549,25218757
3706,42,42,25225546,25226229,699,25224231,25225022,519,25225541
3707,34,34,25232438,25232988,567,25231040,25231836,591,25232427
3708,26,26,25239481,25239897,433,25237866,25238650,821,25239471
3709,34,34,25246423,25246973,566,25244675,25245464,957,25246421
3710,8,8,25252883,25252999,133,25251484,25252278,591,25252869
3711,20,20,25260075,25260391,333,25258294,25259092,965,25260057
3712,40,40,25266601,25267251,666,25265120,25265906,689,25266595
3713,52,52,25273394,25274243,866,25271929,25272720,656,25273376
3714,58,58,25280403,25281352,966,25278738,25279534,858,25280392
3715,50,50,25287262,25288078,833,25285564,25286348,911,25287259
3716,58,58,25294055,25295004,966,25292373,25293162,890,25294052
3717,48,48,25300898,25301680,799,25299183,25299976,907,25300883
3718,20,20,25307490,25307807,333,25305992,25306790,689,25307479
3719,32,32,25314133,25314649,533,25312818,25313604,522,25314126
3720,12,12,25321392,25321575,200,25319627,25320418,964,25321382
3721,18,18,25328235,25328518,299,25326437,25327232,998,25328230
3722,48,48,25334711,25335493,799,25333262,25334046,651,25334697
3723,58,58,25341637,25342586,965,25340072,25340860,765,25341625
3724,32,32,25348646,25349162,533,25346881,25347674,958,25348632
3725,26,26,25355189,25355605,433,25353690,25354488,690,25355178
3726,42,42,25361931,25362614,700,25360516,25361302,620,25361922
3727,22,22,25368874,25369224,366,25367326,25368116,747,25368863
3728,38,38,25375800,25376416,632,25374135,25374930,859,25375789
3729,42,42,25382559,25383242,699,25380961,25381744,813,25382557
3730,26,26,25389085,25389502,433,25387770,25388558,510,25389068
3731,42,42,25396061,25396744,699,25394579,25395372,677,25396049
3732,40,40,25402754,25403403,666,25401389,25402186,551,25402737
3733,32,32,25409680,25410196,532,25408215,25409000,674,25409674
3734,44,44,25416622,25417338,733,25415024,25415814,799,25416613
3735,14,14,25423265,25423481,233,25421833,25422628,619,25423247
3736,54,54,25430141,25431023,899,25428659,25429442,681,25430123
3737,6,6,25437233,25437316,100,25435468,25436256,960,25437216
3738,54,54,25443893,25444775,899,25442278,25443070,809,25443879
3739,22,22,25450402,25450752,366,25449087,25449884,512,25450396
3740,60,60,25457561,25458543,999,25455913,25456698,856,25457554
3741,2,2,25464370,25464387,34,25462722,25463512,843,25464355
3742,50,50,25470880,25471696,832,25469531,25470326,548,25470874
3743,50,50,25478006,25478821,832,25476357,25477140,853,25477993
3744,14,14,25484682,25484898,233,25483167,25483954,721,25484675
3745,46,46,25491757,25492507,766,25489976,25490768,986,25491754
3746,54,54,25498217,25499099,899,25496785,25497582,630,25498212
3747,24,24,25505010,25505393,399,25503611,25504396,609,25505005
3748,58,58,25511752,25512701,966,25510420,25511210,531,25511741
3749,52,52,25519011,25519860,866,25517230,25518024,981,25519005
3750,22,22,25525604,25525954,366,25524039,25524838,759,25525597
3751,60,60,25532164,25533146,998,25530865,25531652,503,25532155
3752,40,40,25539206,25539855,666,25537674,25538466,726,25539192
3753,30,30,25546065,25546548,500,25544484,25545280,780,25546060
3754,42,42,25552958,25553640,699,25551309,25552094,858,25552952
3755,42,42,25559884,25560566,699,25558119,25558908,959,25559867
3756,28,28,25566277,25566726,466,25564928,25565722,542,25566264
3757,4,4,25573186,25573236,66,25571737,25572536,633,25573169
3758,8,8,25580012,25580128,133,25578563,25579350,646,25579996
3759,6,6,25587004,25587087,100,25585373,25586164,823,25586987
3760,44,44,25593514,25594230,732,25592182,25592978,531,25593509
3761,56,56,25600706,25601622,932,25599008,25599792,903,25600695
3762,4,4,25607282,25607332,67,25605817,25606606,673,25607279
3763,34,34,25614258,25614807,566,25612626,25613420,821,25614241
3764,18,18,25620867,25621150,300,25619436,25620234,629,25620863
3765,14,14,25627677,25627893,233,25626262,25627048,623,25627671
3766,20,20,25634769,25635085,333,25633071,25633862,889,25634751
3767,8,8,25641345,25641462,133,25639880,25640676,660,25641336
3768,20,20,25648288,25648604,333,25646706,25647490,788,25648278
3769,56,56,25655114,25656029,932,25653515,25654304,807,25655111
3770,10,10,25661906,25662056,167,25660325,25661118,786,25661904
3771,14,14,25668549,25668765,233,25667134,25667932,609,25668541
3772,46,46,25675741,25676490,766,25673960,25674746,981,25675727
3773,50,50,25682084,25682900,833,25680769,25681560,513,25682073
3774,42,42,25688944,25689626,699,25687578,25688374,567,25688941
3775,34,34,25696019,25696569,566,25694404,25695188,821,25696009
3776,18,18,25702695,25702978,300,25701214,25702002,680,25702682
3777,18,18,25709588,25709871,300,25708023,25708816,760,25709576
3778,14,14,25716231,25716447,233,25714832,25715630,583,25716213
3779,14,14,25723173,25723390,233,25721658,25722444,711,25723155
3780,16,16,25729816,25730066,266,25728467,25729258,540,25729798
3781,8,8,25736975,25737091,133,25735277,25736072,887,25736959
3782,12,12,25743851,25744034,200,25742103,25742886,962,25743848
3783,56,56,25750677,25751592,932,25748912,25749700,962,25750662
3784,8,8,25757136,25757253,134,25755721,25756514,605,25757119
3785,10,10,25764212,25764362,167,25762531,25763328,882,25764210
3786,28,28,25770738,25771188,466,25769356,25770142,585,25770727
3787,34,34,25777731,25778280,566,25776166,25776956,768,25777724
3788,30,30,25784340,25784823,500,25782975,25783770,563,25784333
3789,40,40,25791566,25792215,666,25789801,25790584,968,25791552
3790,30,30,25798392,25798874,499,25796610,25797398,990,25798388
3791,12,12,25805134,25805317,200,25803420,25804212,907,25805119
3792,32,32,25811860,25812376,533,25810229,25811026,830,25811856
3793,6,6,25818803,25818886,100,25817055,25817840,951,25818791
3794,8,8,25825529,25825645,133,25823864,25824654,857,25825511
3795,56,56,25832371,25833287,933,25830673,25831468,892,25832360
3796,8,8,25839164,25839281,133,25837499,25838282,868,25839150
3797,26,26,25845874,25846290,432,25844309,25845096,768,25845864
3798,28,28,25852799,25853249,467,25851118,25851910,886,25852796
3799,8,8,25859442,25859559,133,25857927,25858724,702,25859426
3800,54,54,25866185,25867067,899,25864753,25865538,636,25866174
3801,52,52,25872878,25873727,865,25871562,25872352,513,25872865
3802,52,52,25879737,25880586,866,25878372,25879166,567,25879733
3803,8,8,25886779,25886896,133,25885198,25885980,789,25886769
3804,28,28,25893389,25893838,466,25892007,25892794,591,25893385
3805,42,42,25900165,25900847,699,25898816,25899608,546,25900154
3806,46,46,25907423,25908173,766,25905625,25906422,984,25907406
3807,58,58,25914149,25915098,966,25912451,25913236,898,25914134
3808,38,38,25920626,25921242,632,25919261,25920050,570,25920620
3809,12,12,25927685,25927868,200,25926070,25926864,817,25927681
3810,24,24,25934577,25934960,400,25932879,25933678,881,25934559
3811,52,52,25941403,25942252,866,25939705,25940492,908,25941400
3812,26,26,25947896,25948312,433,25946514,25947306,588,25947894
3813,10,10,25954855,25955005,167,25953324,25954120,719,25954839
3814,2,2,25961615,25961631,33,25960150,25960934,674,25961608
3815,6,6,25968357,25968441,100,25966959,25967748,603,25968351
3816,8,8,25975400,25975516,133,25973768,25974562,829,25975391
3817,26,26,25982359,25982775,433,25980577,25981376,970,25982346
3818,2,2,25988952,25988968,33,25987403,25988190,754,25988944
3819,34,34,25995528,25996077,566,25994213,25995004,510,25995514
3820,32,32,26002454,26002970,533,26001022,26001818,630,26002448
3821,10,10,26009180,26009330,166,26007848,26008632,531,26009163
3822,34,34,26016189,26016738,566,26014657,26015446,739,26016185
3823,42,42,26023015,26023697,699,26021466,26022260,749,26023009
3824,50,50,26030007,26030823,833,26028276,26029074,923,26029997
3825,36,36,26036533,26037116,600,26035102,26035888,639,26036527
3826,54,54,26043493,26044375,899,26041911,26042702,774,26043476
3827,2,2,26050402,26050418,33,26048720,26049516,876,26050392
3828,10,10,26057045,26057194,166,26055546,26056330,701,26057031
3829,48,48,26063771,26064553,799,26062356,26063144,612,26063756
3830,12,12,26070880,26071063,199,26069165,26069958,917,26070875
3831,4,4,26077755,26077805,67,26075974,26076772,967,26077739
3832,38,38,26084149,26084765,632,26082800,26083586,551,26084137
3833,24,24,26090908,26091291,399,26089609,26090400,502,26090902
3834,44,44,26097934,26098649,732,26096419,26097214,702,26097916
3835,28,28,26104826,26105276,466,26103245,26104028,786,26104814
3836,48,48,26111469,26112251,799,26110054,26110842,620,26111462
3837,34,34,26118661,26119211,566,26116863,26117656,998,26118654
3838,22,22,26125304,26125654,366,26123672,26124470,831,26125301
3839,8,8,26132097,26132213,133,26130498,26131284,804,26132088
3840,58,58,26138906,26139855,966,26137308,26138098,793,26138891
3841,52,52,26145515,26146364,866,26144117,26144912,589,26145501
3842,12,12,26152558,26152741,200,26150943,26151726,814,26152540
3843,34,34,26159334,26159883,566,26157752,26158540,778,26159318
3844,44,44,26165993,26166709,733,26164561,26165354,630,26165984
3845,60,60,26173119,26174101,999,26171371,26172168,941,26173109
3846,16,16,26179528,26179778,267,26178197,26178982,533,26179515
3847,32,32,26186371,26186887,533,26185006,26185796,572,26186368
3848,10,10,26193264,26193413,166,26191815,26192610,650,26193260
3849,20,20,26200439,26200755,333,26198641,26199424,998,26200422
3850,48,48,26206766,26207548,799,26205450,26206238,514,26206752
3851,50,50,26213575,26214391,832,26212260,26213052,518,26213570
3852,28,28,26220784,26221233,466,26219069,26219866,914,26220780
3853,12,12,26227477,26227660,199,26225895,26226680,787,26227467
3854,2,2,26234236,26234253,33,26232704,26233494,724,26234218
3855,56,56,26240879,26241794,932,26239513,26240308,565,26240873
3856,30,30,26247671,26248154,500,26246339,26247122,538,26247660
3857,54,54,26254880,26255763,899,26253149,26253936,942,26254878
3858,56,56,26261756,26262672,932,26259958,26260750,993,26261743
3859,50,50,26268149,26268965,833,26266767,26267564,572,26268136
3860,42,42,26275225,26275907,699,26273593,26274378,842,26275220
3861,56,56,26282167,26283083,933,26280402,26281192,964,26282156
3862,18,18,26288827,26289110,299,26287212,26288006,809,26288815
3863,58,58,26295786,26296735,965,26294021,26294820,948,26295768
3864,14,14,26302395,26302612,233,26300847,26301634,745,26302379
3865,22,22,26309188,26309538,366,26307656,26308448,733,26309181
3866,38,38,26316114,26316730,632,26314466,26315262,844,26316106
3867,2,2,26322590,26322607,33,26321291,26322076,500,26322576
3868,36,36,26329699,26330282,599,26328101,26328890,799,26329689
3869,16,16,26336592,26336841,266,26334910,26335704,873,26336577
3870,6,6,26343318,26343401,100,26341719,26342518,793,26343311
3871,4,4,26349910,26349960,67,26348545,26349332,562,26349894
3872,44,44,26356886,26357602,733,26355355,26356146,725,26356871
3873,32,32,26363662,26364178,533,26362164,26362960,697,26363657
3874,54,54,26370771,26371654,899,26368990,26369774,981,26370755
3875,22,22,26377564,26377913,366,26375799,26376588,964,26377552
3876,22,22,26384373,26384723,366,26382608,26383402,953,26384355
3877,14,14,26391033,26391249,233,26389418,26390216,802,26391018
3878,46,46,26397842,26398591,766,26396244,26397030,803,26397833
3879,24,24,26404385,26404768,399,26403053,26403844,523,26404367
3880,32,32,26411311,26411827,532,26409862,26410658,646,26411304
3881,10,10,26418370,26418519,166,26416688,26417472,893,26418365
3882,24,24,26425245,26425628,400,26423497,26424286,957,26425243
3883,6,6,26431672,26431755,100,26430307,26431100,564,26431664
3884,26,26,26438614,26439031,433,26437116,26437914,683,26438597
3885,40,40,26445557,26446206,666,26443942,26444728,811,26445539
3886,44,44,26452499,26453215,733,26450751,26451542,947,26452489
3887,12,12,26459242,26459425,200,26457560,26458356,873,26459229
3888,44,44,26465885,26466601,732,26464386,26465170,704,26465874
3889,38,38,26472711,26473327,632,26471196,26471984,724,26472708
3890,42,42,26479387,26480069,699,26478005,26478798,580,26479378
3891,14,14,26486546,26486762,233,26484814,26485612,918,26486530
3892,14,14,26492989,26493205,233,26491640,26492426,545,26492971
3893,2,2,26500031,26500048,33,26498449,26499240,785,26500025
3894,48,48,26506907,26507689,799,26505259,26506054,839,26506893
3895,54,54,26513550,26514432,899,26512085,26512868,670,26513538
3896,12,12,26520376,26520559,199,26518894,26519682,681,26520363
3897,54,54,26527335,26528217,899,26525703,26526496,823,26527319
3898,10,10,26534061,26534211,166,26532513,26533310,742,26534052
3899,42,42,26540704,26541386,699,26539338,26540124,575,26540699
3900,4,4,26547496,26547546,67,26546148,26546938,545,26547483
3901,32,32,26554738,26555255,533,26552957,26553752,984,26554736
3902,16,16,26561098,26561348,267,26559783,26560566,524,26561090
TRL_NUMBER,TRL_STOP_SIGNAL_DELAY,TRL_TARG_SSD_VRT_RFRSH_COUNT,TRL_TARG_ON_TIME,TRL_STOP_SIGNAL_TIME,TRL_STOP_SIGNAL_DURATION,TRL_FIX_ON_TIME,TRL_FIX_ACQ_TIME,TRL_FIX_HOLD_TIME,TRL_FIXATED_TIME
1,10,10,2532,2682,167,1067,1859,667,2526
2,48,48,8459,9242,799,7876,7890,561,8451
3,10,10,15435,15585,166,13920,14704,725,15429
4,50,50,22461,23276,832,20729,21518,936,22454
5,48,48,28904,29686,799,27538,28332,565,28897
6,46,46,35846,36595,766,34348,35146,694,35840
7,34,34,42522,43072,566,41174,41960,556,42516
8,24,24,49365,49748,399,47983,48774,584,49358
9,38,38,56224,56840,633,54792,55588,629,56217
10,56,56,63183,64099,932,61618,62402,775,63177
11,10,10,70109,70259,166,68427,69216,886,70102
12,42,42,76652,77334,699,75237,76030,616,76646
13,52,52,83578,84427,865,82046,82844,727,83571
14,14,14,90337,90553,233,88872,89658,673,90331
15,48,48,97396,98179,799,95681,96472,918,97390
16,10,10,104072,104222,167,102491,103286,780,104066
17,14,14,110648,110865,233,109316,110100,541,110641
18,48,48,117424,118207,799,116126,116914,504,117418
19,20,20,124250,124567,333,122935,123728,516,124244
20,58,58,130477,131426,965,129744,129759,710,130469
21,54,54,137103,137985,899,135788,136573,524,137097
22,42,42,144079,144761,699,142597,143387,685,144072
23,16,16,151188,151437,266,149406,150201,980,151181
24,28,28,157548,157997,466,156232,157015,526,157541
25,34,34,164623,165173,566,163042,163829,788,164617
26,46,46,171183,171932,766,169851,170643,533,171176
27,36,36,178092,178675,599,176660,177457,628,178085
28,60,60,184868,185850,999,183486,184271,590,184861
29,40,40,191727,192376,666,190295,191085,635,191720
30,12,12,198836,199019,200,197105,197899,931,198830
31,48,48,205296,206078,799,203931,204713,577,205290
32,6,6,212205,212288,100,210740,211527,672,212199
33,20,20,219097,219414,333,217549,218341,750,219091
34,52,52,225774,226623,865,224358,225155,612,225767
35,10,10,232616,232766,167,231184,231969,640,232609
36,16,16,239359,239609,266,237994,238783,570,239353
37,4,4,246418,246468,66,244803,245597,815,246412
38,46,46,253310,254060,766,251612,252411,893,253304
39,8,8,260070,260186,133,258438,259225,838,260063
40,10,10,266912,267062,167,265247,266039,867,266906
41,46,46,273439,274188,765,272057,272853,579,273432
42,46,46,280564,281313,766,278883,279667,891,280558
43,10,10,287124,287274,166,285692,286481,636,287117
44,18,18,294266,294549,300,292501,293295,965,294260
45,58,58,300609,301558,966,299311,300109,494,300603
46,10,10,307818,307968,166,306136,306923,888,307811
47,32,32,314261,314777,533,312946,313737,518,314255
48,8,8,321503,321620,133,319755,320551,946,321497
49,32,32,328013,328529,533,326581,327365,641,328006
50,30,30,334789,335272,499,333390,334179,603,334782
51,58,58,341914,342863,966,340200,340993,916,341909
52,50,50,348457,349273,833,347009,347807,644,348451
53,32,32,355583,356099,533,353835,354621,956,355577
54,50,50,361976,362792,832,360644,361435,534,361969
55,6,6,368885,368968,100,367453,368249,629,368878
56,38,38,375644,376260,633,374279,375063,575,375638
57,32,32,382787,383303,532,381089,381877,904,382781
58,12,12,388863,389047,200,387898,387908,949,388857
59,26,26,395240,395656,433,393925,394722,512,395234
60,46,46,402232,402981,766,400751,401536,690,402226
61,54,54,409042,409924,899,407560,408350,685,409035
62,28,28,415734,416184,466,414369,415164,564,415728
63,54,54,422743,423626,899,421195,421978,759,422737
64,34,34,429669,430219,566,428004,428792,871,429663
65,36,36,436245,436828,600,434814,435606,633,436239
66,22,22,443388,443737,366,441623,442420,962,443382
67,16,16,450080,450330,267,448449,449234,840,450074
68,30,30,456956,457439,500,455258,456048,902,456950
69,36,36,463533,464115,599,462067,462862,664,463526
70,56,56,470575,471491,932,468893,469676,892,470568
71,10,10,477351,477501,166,475703,476490,855,477345
72,32,32,484044,484560,532,482512,483304,733,484037
73,18,18,490903,491186,300,489321,490118,778,490896
74,36,36,497679,498262,599,496147,496932,740,497672
75,16,16,504671,504921,267,502956,503746,919,504665
76,24,24,511447,511830,400,509766,510560,881,511441
77,14,14,518273,518490,233,516575,517374,893,518267
78,6,6,524050,524133,100,523401,523405,638,524043
79,28,28,531093,531542,466,529428,530219,868,531087
80,60,60,537636,538618,998,536237,537033,596,537629
81,18,18,544511,544794,300,543063,543847,658,544505
82,36,36,551404,551987,599,549872,550661,736,551397
83,60,60,558463,559445,999,556682,557475,982,558457
84,58,58,565206,566155,965,563491,564289,911,565200
85,52,52,571865,572714,866,570317,571103,756,571859
86,36,36,578541,579124,600,577126,577917,618,578535
87,10,10,585567,585717,166,583935,584731,829,585560
88,2,2,592293,592310,33,590761,591545,741,592286
89,52,52,599219,600068,866,597571,598359,854,599213
90,12,12,606061,606244,200,604380,605173,882,606055
91,54,54,612787,613670,899,611189,611987,794,612781
92,12,12,619497,619680,200,618015,618801,689,619490
93,46,46,626156,626905,766,624824,625615,534,626149
94,18,18,633115,633398,300,631634,632429,680,633109
95,46,46,639841,640591,766,638460,639243,592,639835
96,38,38,646850,647466,633,645269,646057,787,646844
97,44,44,653643,654359,733,652078,652871,766,653637
98,58,58,660186,661135,966,658887,659685,494,660179
99,14,14,667245,667461,233,665713,666499,739,667238
100,22,22,674054,674404,367,672523,673313,735,674048
101,48,48,680914,681696,799,679332,680127,780,680907
102,4,4,687756,687806,67,686158,686941,809,687750
103,8,8,694615,694732,134,692967,693755,854,694609
104,36,36,701125,701708,599,699776,700569,549,701118
105,2,2,708301,708317,33,706586,707383,912,708295
106,20,20,714860,715176,333,713412,714197,657,714854
107,4,4,720854,720904,66,720221,720228,618,720846
108,56,56,727546,728462,933,726248,727042,498,727540
109,16,16,734522,734772,266,733057,733856,660,734516
110,2,2,741448,741465,33,739883,740670,772,741442
111,18,18,748307,748590,300,746692,747484,817,748301
112,32,32,754983,755499,533,753502,754298,679,754977
113,6,6,761876,761959,100,760327,761112,757,761869
114,40,40,768901,769551,666,767137,767926,970,768896
115,42,42,775661,776343,699,773946,774740,915,775655
116,42,42,782187,782870,699,780755,781554,626,782180
117,48,48,789030,789812,799,787581,788368,655,789023
118,20,20,795939,796255,333,794391,795182,751,795933
119,42,42,802865,803547,699,801200,801996,863,802859
120,34,34,809591,810140,566,808026,808810,775,809585
121,18,18,816600,816883,299,814835,815624,970,816594
122,8,8,823043,823159,133,821644,822438,598,823036
123,16,16,830002,830252,266,828454,829252,744,829996
124,52,52,837011,837860,866,835280,836066,939,837005
125,36,36,843404,843987,599,842089,842880,518,843398
126,14,14,850396,850613,234,848898,849694,696,850390
127,34,34,857172,857722,567,855724,856508,658,857166
128,60,60,863932,864914,999,862533,863322,603,863925
129,18,18,870758,871041,299,869343,870136,616,870752
130,12,12,877850,878033,200,876152,876950,894,877844
131,28,28,884743,885192,466,882978,883764,973,884737
132,38,38,891369,891985,632,889787,890578,784,891362
133,58,58,898012,898961,965,896596,897392,613,898005
134,54,54,905004,905886,899,903422,904206,791,904997
135,38,38,911813,912429,633,910232,911020,787,911807
136,8,8,918573,918689,133,917041,917834,732,918566
137,38,38,925382,925998,633,923850,924648,727,925375
138,26,26,932291,932707,433,930676,931462,823,932285
139,58,58,938834,939783,966,937485,938276,551,938827
140,18,18,945810,946093,299,944295,945090,714,945804
141,40,40,952869,953518,666,951121,951904,959,952863
142,34,34,959645,960194,566,957930,958718,921,959639
143,12,12,966154,966337,200,964739,965532,616,966148
144,4,4,972980,973030,67,971548,972346,627,972973
145,6,6,979923,980006,100,978374,979160,756,979916
146,30,30,986599,987082,499,985184,985974,619,986593
147,60,60,993458,994440,999,991993,992788,664,993452
148,48,48,1000367,1001150,799,998819,999602,759,1000361
149,2,2,1007343,1007360,33,1005628,1006416,921,1007337
150,38,38,1014219,1014835,633,1012438,1013230,983,1014213
151,28,28,1020562,1021012,466,1019247,1020044,512,1020556
152,4,4,1027621,1027671,67,1026073,1026858,757,1027615
153,6,6,1034497,1034580,100,1032882,1033672,819,1034491
154,18,18,1041290,1041573,299,1039691,1040486,797,1041283
155,26,26,1048265,1048682,433,1046517,1047300,959,1048259
156,10,10,1054658,1054808,167,1053327,1054114,538,1054652
157,42,42,1061867,1062550,700,1060136,1060928,933,1061861
158,54,54,1068460,1069342,899,1066945,1067742,712,1068454
159,28,28,1075369,1075819,466,1073771,1074556,807,1075363
160,32,32,1082229,1082745,532,1080580,1081370,852,1082222
161,42,42,1089154,1089837,700,1087390,1088184,965,1089149
162,6,6,1095980,1096064,100,1094216,1094998,977,1095975
163,12,12,1102573,1102756,200,1101025,1101812,755,1102567
164,18,18,1109266,1109549,300,1107834,1108626,633,1109259
165,30,30,1115959,1116441,499,1114643,1115440,512,1115952
166,44,44,1123151,1123867,732,1121469,1122254,890,1123144
167,56,56,1129977,1130892,932,1128279,1129068,903,1129971
168,26,26,1136636,1137052,433,1135088,1135882,748,1136630
169,20,20,1143296,1143612,333,1141897,1142696,593,1143289
170,56,56,1150122,1151037,932,1148723,1149510,605,1150115
171,40,40,1157264,1157913,666,1155532,1156324,933,1157257
172,56,56,1164073,1164989,932,1162342,1163138,929,1164067
173,60,60,1170683,1171665,999,1169168,1169952,725,1170677
174,34,34,1177475,1178025,566,1175977,1176766,703,1177469
175,48,48,1184568,1185350,799,1182786,1183580,981,1184561
176,44,44,1191077,1191793,733,1189595,1190394,676,1191070
177,60,60,1198120,1199102,998,1196421,1197208,905,1198113
178,10,10,1204679,1204829,167,1203231,1204022,651,1204673
179,12,12,1211721,1211905,200,1210040,1210836,879,1211715
180,56,56,1218181,1219097,932,1216866,1217650,525,1218175
181,34,34,1225090,1225640,566,1223675,1224464,620,1225084
182,48,48,1231900,1232682,799,1230484,1231278,615,1231893
183,18,18,1238659,1238942,300,1237294,1238092,561,1238653
184,14,14,1245685,1245901,233,1244120,1244906,773,1245679
185,18,18,1252228,1252511,299,1250929,1251720,501,1252221
186,60,60,1259170,1260152,999,1257738,1258534,629,1259163
187,56,56,1266113,1267028,932,1264564,1265348,758,1266106
188,18,18,1273105,1273388,300,1271373,1272162,936,1273098
189,44,44,1279548,1280264,733,1278183,1278976,566,1279542
190,18,18,1286540,1286823,300,1284992,1285790,744,1286534
191,8,8,1293466,1293583,133,1291818,1292604,856,1293460
192,34,34,1300026,1300575,566,1298627,1299418,601,1300019
193,10,10,1306768,1306918,167,1305437,1306232,530,1306762
194,2,2,1313827,1313844,34,1312263,1313046,776,1313822
195,34,34,1320454,1321003,566,1319072,1319860,587,1320447
196,26,26,1327579,1327995,433,1325881,1326674,899,1327573
197,28,28,1334139,1334588,466,1332690,1333488,644,1334132
198,58,58,1340815,1341764,966,1339516,1340302,506,1340808
199,34,34,1347841,1348390,566,1346326,1347116,719,1347835
200,4,4,1354450,1354500,67,1353135,1353930,514,1354444
201,22,22,1361343,1361692,366,1359961,1360744,592,1361336
202,58,58,1368069,1369018,965,1366770,1367558,504,1368062
203,18,18,1375044,1375327,300,1373579,1374372,666,1375038
204,42,42,1381737,1382420,699,1380389,1381186,545,1381731
205,14,14,1388896,1389113,233,1387215,1388000,890,1388890
206,58,58,1395655,1396604,966,1394024,1394814,835,1395649
207,18,18,1402182,1402465,299,1400833,1401628,547,1402175
208,40,40,1409024,1409674,666,1407659,1408442,576,1409018
209,20,20,1415850,1416167,333,1414468,1415256,587,1415843
210,56,56,1422660,1423575,932,1421278,1422070,583,1422653
211,48,48,1429452,1430235,799,1428087,1428884,562,1429446
212,60,60,1436644,1437627,999,1434913,1435698,940,1436638
213,34,34,1443387,1443936,566,1441722,1442512,869,1443381
214,26,26,1450146,1450563,433,1448531,1449326,814,1450140
215,46,46,1456939,1457688,766,1455357,1456140,792,1456932
216,44,44,1463465,1464181,733,1462167,1462954,505,1463459
217,22,22,1470741,1471090,366,1468976,1469768,967,1470735
218,50,50,1477084,1477900,832,1475785,1476582,495,1477077
219,20,20,1483976,1484293,333,1482611,1483396,574,1483970
220,56,56,1490902,1491818,933,1489420,1490210,685,1490895
221,42,42,1497562,1498244,699,1496230,1497024,531,1497555
222,50,50,1504504,1505320,833,1503039,1503838,660,1504498
223,20,20,1511413,1511730,333,1509865,1510652,755,1511407
224,24,24,1518256,1518639,399,1516674,1517466,783,1518249
225,56,56,1525182,1526097,932,1523484,1524280,896,1525176
226,40,40,1531908,1532557,666,1530309,1531094,807,1531901
227,54,54,1538551,1539433,899,1537119,1537908,636,1538544
228,8,8,1545243,1545360,134,1543928,1544722,515,1545237
229,38,38,1552269,1552885,633,1550737,1551536,726,1552262
230,34,34,1559095,1559644,566,1557563,1558350,738,1559088
231,12,12,1565671,1565854,200,1564373,1565164,501,1565665
232,32,32,1572680,1573196,533,1571182,1571978,696,1572674
233,18,18,1579573,1579856,299,1578008,1578792,775,1579567
234,26,26,1586299,1586715,433,1584817,1585606,686,1586292
235,44,44,1592992,1593707,732,1591626,1592420,565,1592985
236,52,52,1599984,1600833,866,1598436,1599234,744,1599978
237,24,24,1605811,1606194,400,1605262,1605265,539,1605804
238,24,24,1612654,1613036,399,1611288,1612079,568,1612647
239,2,2,1619579,1619596,34,1618098,1618893,680,1619573
240,58,58,1626505,1627454,966,1624924,1625707,792,1626499
241,6,6,1633098,1633181,100,1631733,1632521,571,1633092
242,10,10,1640307,1640457,166,1638542,1639335,966,1640301
243,50,50,1647116,1647932,833,1645351,1646149,961,1647110
244,54,54,1653509,1654392,899,1652177,1652963,539,1653502
245,58,58,1660352,1661301,965,1658987,1659777,569,1660346
246,10,10,1667444,1667594,167,1665796,1666591,847,1667438
247,8,8,1674054,1674170,133,1672622,1673405,642,1674047
248,48,48,1680813,1681595,799,1679431,1680219,587,1680806
249,28,28,1687905,1688355,466,1686240,1687033,866,1687899
250,34,34,1694798,1695347,566,1693050,1693847,945,1694792
251,20,20,1701208,1701524,333,1699876,1700661,540,1701201
252,34,34,1708133,1708683,566,1706685,1707475,652,1708127
253,40,40,1715076,1715725,666,1713494,1714289,780,1715069
254,36,36,1721819,1722401,599,1720320,1721103,709,1721812
255,22,22,1728894,1729244,367,1727129,1727917,971,1728888
256,32,32,1735554,1736070,532,1733939,1734731,817,1735548
257,12,12,1742446,1742629,200,1740748,1741545,895,1742440
258,52,52,1749172,1750021,866,1747574,1748359,807,1749166
259,38,38,1755732,1756348,632,1754383,1755173,552,1755725
260,4,4,1762841,1762891,66,1761193,1761987,848,1762835
261,44,44,1769450,1770166,733,1768018,1768801,642,1769443
262,24,24,1776309,1776692,400,1774828,1775615,688,1776303
263,54,54,1783269,1784151,899,1781637,1782429,833,1783262
264,34,34,1790111,1790661,566,1788446,1789243,862,1790105
265,46,46,1796604,1797353,766,1795272,1796057,540,1796597
266,10,10,1803480,1803630,167,1802082,1802871,603,1803474
267,12,12,1810323,1810506,199,1808891,1809685,631,1810316
268,36,36,1817398,1817981,600,1815700,1816499,893,1817392
269,36,36,1824158,1824740,599,1822526,1823313,838,1824151
270,24,24,1831050,1831433,400,1829335,1830127,917,1831044
271,36,36,1837809,1838392,600,1836145,1836941,863,1837804
272,44,44,1844585,1845301,733,1842971,1843755,825,1844580
273,40,40,1851395,1852044,666,1849780,1850569,820,1851389
274,36,36,1858137,1858720,600,1856589,1857383,748,1858131
275,18,18,1864730,1865013,300,1863398,1864197,526,1864723
276,52,52,1871639,1872489,866,1870224,1871011,622,1871633
277,36,36,1878782,1879364,599,1877034,1877825,951,1878776
278,28,28,1885291,1885741,467,1883843,1884639,646,1885285
279,52,52,1892201,1893050,865,1890669,1891453,741,1892194
280,6,6,1898910,1898993,100,1897478,1898267,636,1898903
281,42,42,1905802,1906485,700,1904287,1905081,715,1905796
282,10,10,1912562,1912712,166,1911097,1911895,661,1912556
283,58,58,1919221,1920170,966,1917923,1918709,506,1919215
284,8,8,1926097,1926214,133,1924732,1925523,568,1926091
285,56,56,1933073,1933989,932,1931541,1932337,729,1933066
286,42,42,1939932,1940615,699,1938367,1939151,775,1939926
287,60,60,1946625,1947607,999,1945176,1945965,653,1946618
288,48,48,1953284,1954067,799,1951986,1952779,499,1953278
289,52,52,1960127,1960976,866,1958795,1959593,527,1960120
290,44,44,1967236,1967952,732,1965621,1966407,823,1967230
291,2,2,1973779,1973795,33,1972430,1973221,551,1973772
292,36,36,1980838,1981420,599,1979240,1980035,797,1980832
293,58,58,1987531,1988480,965,1986065,1986849,675,1987524
294,48,48,1993691,1994473,799,1992875,1992880,804,1993684
295,40,40,2000250,2000899,666,1998902,1999694,550,2000244
296,4,4,2007026,2007076,67,2005711,2006508,512,2007020
297,42,42,2014168,2014851,700,2012537,2013322,840,2014162
298,26,26,2021111,2021527,433,2019346,2020136,969,2021105
299,20,20,2027537,2027853,333,2026155,2026950,580,2027530
300,8,8,2034430,2034546,133,2032981,2033764,659,2034423
301,18,18,2041222,2041505,300,2039791,2040578,638,2041216
302,20,20,2048132,2048448,333,2046600,2047392,733,2048125
303,40,40,2054758,2055407,666,2053409,2054206,545,2054751
304,30,30,2061833,2062316,500,2060235,2061020,807,2061827
305,48,48,2068593,2069375,799,2067044,2067834,752,2068586
306,10,10,2075469,2075618,166,2073854,2074648,815,2075463
307,10,10,2082145,2082294,166,2080680,2081462,677,2082139
308,10,10,2089154,2089304,166,2087489,2088276,872,2089148
309,22,22,2095663,2096013,367,2094298,2095090,567,2095657
310,56,56,2102606,2103521,932,2101107,2101904,695,2102599
311,56,56,2109348,2110264,933,2107933,2108718,624,2109342
312,20,20,2116041,2116358,333,2114743,2115532,503,2116035
313,46,46,2123250,2123999,766,2121552,2122346,898,2123244
314,56,56,2129826,2130742,933,2128361,2129160,660,2129820
315,18,18,2136569,2136852,300,2135187,2135974,588,2136562
316,56,56,2143495,2144410,932,2141996,2142788,700,2143488
317,42,42,2150454,2151137,699,2148806,2149602,846,2150448
318,2,2,2156980,2156997,34,2155632,2156416,558,2156974
319,40,40,2164122,2164772,666,2162441,2163230,886,2164116
320,54,54,2170599,2171481,899,2169250,2170044,548,2170592
321,42,42,2177791,2178474,699,2176060,2176858,927,2177785
322,54,54,2184317,2185200,899,2182885,2183672,638,2184310
323,52,52,2190227,2191077,866,2189695,2189703,517,2190220
324,52,52,2197203,2198052,866,2195722,2196517,680,2197197
325,56,56,2204212,2205128,933,2202547,2203331,875,2204206
326,10,10,2211105,2211255,166,2209357,2210145,954,2211099
327,56,56,2217881,2218797,932,2216166,2216959,916,2217875
328,46,46,2224407,2225156,766,2222975,2223773,627,2224400
329,18,18,2231116,2231400,300,2229801,2230587,523,2231110
330,36,36,2238325,2238908,600,2236611,2237401,919,2238320
331,58,58,2244785,2245734,966,2243420,2244215,564,2244779
332,58,58,2251544,2252493,966,2250246,2251029,509,2251538
333,10,10,2258770,2258920,166,2257055,2257843,921,2258764
334,42,42,2265296,2265979,699,2263864,2264657,632,2265289
335,14,14,2272438,2272655,233,2270674,2271471,962,2272433
336,24,24,2279048,2279431,399,2277500,2278285,757,2279042
337,4,4,2286007,2286057,67,2284309,2285099,902,2286001
338,22,22,2292550,2292900,366,2291118,2291913,630,2292543
339,56,56,2299359,2300275,933,2297944,2298727,626,2299353
340,40,40,2306452,2307101,665,2304753,2305541,904,2306445
341,34,34,2313311,2313860,566,2311563,2312355,950,2313305
342,40,40,2320153,2320803,666,2318372,2319169,978,2320147
343,42,42,2326896,2327579,699,2325198,2325983,907,2326890
344,58,58,2333406,2334355,965,2332007,2332797,602,2333399
345,10,10,2340298,2340448,167,2338816,2339611,680,2340291
346,24,24,2347407,2347790,400,2345642,2346425,976,2347401
347,20,20,2353983,2354300,333,2352452,2353239,738,2353977
348,56,56,2360626,2361542,932,2359261,2360053,567,2360620
349,48,48,2367685,2368468,799,2366070,2366867,812,2367679
350,34,34,2374561,2375110,566,2372896,2373681,874,2374555
351,18,18,2381237,2381520,300,2379705,2380495,735,2381230
352,40,40,2387813,2388463,666,2386515,2387309,498,2387807
353,18,18,2394956,2395239,299,2393324,2394123,826,2394949
354,44,44,2401548,2402264,733,2400150,2400937,605,2401542
355,56,56,2408624,2409540,932,2406959,2407751,867,2408618
356,48,48,2415350,2416133,799,2413769,2414565,779,2415344
357,26,26,2422176,2422592,433,2420594,2421379,790,2422169
358,30,30,2429119,2429601,499,2427404,2428193,920,2429113
359,44,44,2435611,2436327,733,2434213,2435007,598,2435605
360,24,24,2442554,2442937,400,2441022,2441821,726,2442547
361,12,12,2449546,2449730,200,2447848,2448635,905,2449540
362,22,22,2456206,2456555,366,2454658,2455449,751,2456200
363,28,28,2462982,2463431,466,2461467,2462263,713,2462976
364,36,36,2469891,2470474,599,2468293,2469077,808,2469885
365,48,48,2476784,2477566,799,2475102,2475891,886,2476777
366,38,38,2483526,2484142,633,2481911,2482705,815,2483520
367,40,40,2490052,2490702,666,2488721,2489519,527,2490046
368,6,6,2497328,2497411,100,2495547,2496333,989,2497322
369,18,18,2503838,2504121,299,2502356,2503147,684,2503831
370,52,52,2510514,2511363,865,2509165,2509961,546,2510507
371,50,50,2517456,2518272,833,2515991,2516775,675,2517450
372,12,12,2524465,2524648,200,2522800,2523589,870,2524459
373,16,16,2531358,2531607,266,2529610,2530403,949,2531352
374,54,54,2537917,2538800,899,2536419,2537217,694,2537911
375,28,28,2544876,2545326,467,2543245,2544031,839,2544870
376,2,2,2551619,2551636,33,2550054,2550845,768,2551613
377,48,48,2558478,2559261,799,2556863,2557659,813,2558472
378,32,32,2565104,2565621,533,2563689,2564473,625,2565098
379,8,8,2571814,2571930,133,2570499,2571287,521,2571808
380,16,16,2578656,2578906,267,2577308,2578101,549,2578650
381,60,60,2585532,2586515,999,2584117,2584915,611,2585526
382,10,10,2592708,2592858,166,2590943,2591729,973,2592702
383,38,38,2599151,2599767,633,2597752,2598543,601,2599144
384,56,56,2606060,2606976,932,2604562,2605357,697,2606054
385,58,58,2613102,2614051,966,2611388,2612171,926,2613097
386,22,22,2619679,2620028,366,2618197,2618985,687,2619672
387,42,42,2626604,2627287,700,2625006,2625799,799,2626598
388,34,34,2633547,2634096,566,2631815,2632613,927,2633540
389,6,6,2640223,2640306,100,2638641,2639427,789,2640216
390,46,46,2647132,2647881,766,2645451,2646241,885,2647126
391,16,16,2653991,2654241,267,2652260,2653055,930,2653985
392,12,12,2660767,2660951,200,2659086,2659869,892,2660761
393,18,18,2667227,2667510,300,2665895,2666683,537,2667220
394,22,22,2674253,2674602,366,2672704,2673497,749,2674246
395,30,30,2680879,2681362,499,2679514,2680311,562,2680873
396,10,10,2688021,2688171,167,2686340,2687125,890,2688015
397,56,56,2694914,2695829,932,2693149,2693939,969,2694908
398,54,54,2701440,2702322,899,2699958,2700753,680,2701433
399,50,50,2708432,2709248,833,2706784,2707567,859,2708426
400,58,58,2715009,2715958,965,2713594,2714381,622,2715003
401,16,16,2721868,2722118,266,2720403,2721195,667,2721862
402,4,4,2728710,2728760,67,2727212,2728009,695,2728704
403,48,48,2735570,2736352,799,2734038,2734823,740,2735563
404,16,16,2742579,2742828,266,2740847,2741637,935,2742572
405,36,36,2749072,2749654,599,2747657,2748451,615,2749066
406,48,48,2755881,2756663,799,2754483,2755265,610,2755875
407,6,6,2762907,2762990,100,2761292,2762079,822,2762901
408,2,2,2769466,2769483,34,2768101,2768893,567,2769460
409,50,50,2776542,2777358,832,2774910,2775707,828,2776535
410,48,48,2783251,2784034,799,2781736,2782521,724,2783245
411,10,10,2790210,2790360,167,2788546,2789335,870,2790205
412,40,40,2797086,2797736,666,2795355,2796149,931,2797080
413,50,50,2803746,2804562,832,2802164,2802963,776,2803739
414,24,24,2810722,2811104,399,2808990,2809777,938,2810715
415,32,32,2816349,2816865,533,2815799,2815808,533,2816341
416,60,60,2823175,2824157,999,2821826,2822622,546,2823168
417,30,30,2830350,2830833,500,2828652,2829436,908,2830344
418,22,22,2836877,2837226,366,2835461,2836250,620,2836870
419,50,50,2844002,2844818,833,2842271,2843064,932,2843996
420,36,36,2850445,2851028,600,2849080,2849878,561,2850439
421,2,2,2857671,2857687,33,2855906,2856692,973,2857665
422,28,28,2864480,2864929,466,2862715,2863506,968,2864474
423,50,50,2871089,2871905,833,2869524,2870320,763,2871083
424,18,18,2878115,2878398,300,2876350,2877134,975,2878109
425,40,40,2884808,2885457,666,2883160,2883948,854,2884802
426,44,44,2891268,2891983,732,2889969,2890762,499,2891261
427,46,46,2898193,2898943,766,2896778,2897576,611,2898187
428,30,30,2905369,2905852,499,2903604,2904390,973,2905363
429,58,58,2912112,2913061,965,2910413,2911204,901,2912105
430,22,22,2918854,2919204,367,2917223,2918018,830,2918848
431,18,18,2925664,2925947,299,2924049,2924832,826,2925658
432,30,30,2932589,2933072,500,2930858,2931646,937,2932583
433,48,48,2939249,2940031,799,2937667,2938460,782,2939242
434,20,20,2946158,2946474,333,2944477,2945274,878,2946152
435,58,58,2952701,2953650,966,2951303,2952088,607,2952695
436,52,52,2959527,2960376,866,2958112,2958902,619,2959521
437,42,42,2966353,2967035,699,2964921,2965716,630,2966346
438,4,4,2973362,2973412,67,2971747,2972530,826,2973356
439,8,8,2980338,2980454,133,2978556,2979344,987,2980331
440,34,34,2986881,2987430,566,2985366,2986158,717,2986875
441,48,48,2993823,2994606,799,2992175,2992972,845,2993817
442,14,14,3000316,3000532,233,2999001,2999786,524,3000310
443,32,32,3007259,3007775,532,3005810,3006600,652,3007252
444,8,8,3014168,3014284,133,3012619,3013414,747,3014161
445,16,16,3021010,3021260,267,3019445,3020228,776,3021004
446,24,24,3028003,3028386,399,3026255,3027042,955,3027997
447,60,60,3034529,3035511,999,3033064,3033856,667,3034523
448,2,2,3041655,3041671,33,3039873,3040670,978,3041648
449,36,36,3048480,3049063,600,3046699,3047484,990,3048474
450,14,14,3055256,3055473,234,3053508,3054298,952,3055250
451,2,2,3061883,3061899,33,3060318,3061112,765,3061877
452,8,8,3068642,3068759,133,3067144,3067926,710,3068636
453,18,18,3075651,3075934,300,3073953,3074740,905,3075645
454,46,46,3082494,3083243,765,3080762,3081554,933,3082487
455,40,40,3088970,3089619,666,3087571,3088368,595,3088963
456,52,52,3095896,3096745,866,3094397,3095182,707,3095889
457,58,58,3102971,3103920,966,3101207,3101996,970,3102966
458,18,18,3109581,3109864,300,3108016,3108810,765,3109575
459,14,14,3116407,3116623,233,3114825,3115624,776,3116400
460,56,56,3123383,3124298,932,3121651,3122438,938,3123376
461,26,26,3130159,3130575,433,3128460,3129252,900,3130152
462,8,8,3137068,3137184,133,3135270,3136066,996,3137062
463,12,12,3143428,3143611,199,3142096,3142880,541,3143421
464,40,40,3150320,3150969,666,3148905,3149694,620,3150314
465,2,2,3157279,3157296,34,3155714,3156508,765,3157273
466,4,4,3164105,3164155,67,3162524,3163322,777,3164099
467,36,36,3171064,3171647,600,3169349,3170136,922,3171058
468,16,16,3177491,3177740,266,3176159,3176950,534,3177484
469,48,48,3184633,3185415,799,3182968,3183764,863,3184627
470,10,10,3191559,3191709,166,3189794,3190578,975,3191553
471,50,50,3198335,3199151,832,3196603,3197392,936,3198328
472,6,6,3205077,3205161,100,3203413,3204206,866,3205072
473,14,14,3211587,3211803,233,3210222,3211020,561,3211581
474,16,16,3218513,3218763,266,3217048,3217834,673,3218507
475,44,44,3225589,3226304,732,3223857,3224648,934,3225582
476,38,38,3232032,3232648,632,3230666,3231462,563,3232025
477,56,56,3239041,3239956,932,3237492,3238276,758,3239034
478,60,60,3245933,3246915,999,3244302,3245090,837,3245927
479,16,16,3252659,3252909,267,3251111,3251904,749,3252653
480,8,8,3259468,3259585,134,3257920,3258718,744,3259462
481,50,50,3266478,3267293,832,3264746,3265532,939,3266471
482,18,18,3273220,3273503,300,3271555,3272346,868,3273214
483,42,42,3280013,3280695,699,3278365,3279160,847,3280007
484,2,2,3286839,3286855,33,3285191,3285974,859,3286833
485,42,42,3293348,3294031,700,3292000,3292788,554,3293342
486,46,46,3300457,3301207,766,3298809,3299602,849,3300451
487,10,10,3307034,3307183,166,3305618,3306416,611,3307027
488,46,46,3313860,3314609,765,3312444,3313230,623,3313853
489,28,28,3320968,3321418,467,3319254,3320044,919,3320963
490,58,58,3327495,3328444,965,3326063,3326858,630,3327488
491,10,10,3334287,3334437,167,3332889,3333672,609,3334281
492,30,30,3341030,3341513,500,3339698,3340486,537,3341023
493,52,52,3348139,3348988,866,3346507,3347300,832,3348132
494,48,48,3354965,3355747,799,3353317,3354114,845,3354959
495,16,16,3361674,3361924,267,3360143,3360928,740,3361668
496,48,48,3368517,3369299,799,3366952,3367742,769,3368511
497,16,16,3375526,3375776,266,3373761,3374556,964,3375520
498,12,12,3382219,3382402,200,3380587,3381370,842,3382212
499,56,56,3388928,3389844,932,3387396,3388184,737,3388921
500,18,18,3395804,3396087,300,3394206,3394998,800,3395798
501,24,24,3402597,3402980,399,3401015,3401812,778,3402590
502,46,46,3409156,3409905,766,3407841,3408626,524,3409150
503,28,28,3416348,3416798,467,3414650,3415440,902,3416342
504,42,42,3423158,3423840,699,3421460,3422254,898,3423152
505,28,28,3430050,3430500,466,3428285,3429068,976,3430044
506,2,2,3436660,3436676,33,3435095,3435882,772,3436654
507,10,10,3443536,3443685,166,3441904,3442696,833,3443529
508,28,28,3450378,3450828,466,3448713,3449510,862,3450372
509,46,46,3456988,3457737,766,3455539,3456324,657,3456981
510,22,22,3463897,3464246,366,3462349,3463138,753,3463891
511,42,42,3470723,3471405,699,3469158,3469952,765,3470717
512,2,2,3477432,3477449,34,3475967,3476766,660,3477426
513,38,38,3484375,3484991,632,3482793,3483580,788,3484368
514,12,12,3491284,3491467,200,3489602,3490394,883,3491277
515,42,42,3497993,3498676,700,3496412,3497208,779,3497987
516,60,60,3504669,3505652,999,3503238,3504022,641,3504663
517,10,10,3511812,3511961,166,3510047,3510836,970,3511806
518,14,14,3518205,3518421,233,3516856,3517650,548,3518198
519,30,30,3524581,3525064,500,3523665,3523681,893,3524574
520,18,18,3531124,3531407,300,3529709,3530495,623,3531118
521,2,2,3537917,3537933,33,3536518,3537309,601,3537910
522,14,14,3544909,3545125,233,3543327,3544123,779,3544902
523,44,44,3551835,3552551,732,3550153,3550937,891,3551828
524,48,48,3558511,3559293,799,3556963,3557751,754,3558505
525,2,2,3565537,3565553,33,3563772,3564565,966,3565531
526,18,18,3571996,3572279,300,3570581,3571379,611,3571990
527,60,60,3578839,3579821,999,3577407,3578193,639,3578832
528,16,16,3585715,3585965,266,3584216,3585007,701,3585708
529,10,10,3592674,3592824,166,3591026,3591821,847,3592668
530,60,60,3599517,3600499,998,3597852,3598635,876,3599511
531,2,2,3606043,3606059,33,3604661,3605449,587,3606036
532,12,12,3613218,3613401,200,3611470,3612263,949,3613212
533,42,42,3619578,3620261,699,3618280,3619077,495,3619572
534,38,38,3626720,3627336,633,3625105,3625891,823,3626714
535,16,16,3633263,3633513,267,3631915,3632705,552,3633257
536,26,26,3640206,3640622,433,3638724,3639519,680,3640199
537,28,28,3647148,3647598,466,3645550,3646333,809,3647142
538,10,10,3653841,3653991,166,3652359,3653147,687,3653834
539,48,48,3660900,3661682,799,3659169,3659961,933,3660894
540,24,24,3667759,3668142,400,3665978,3666775,978,3667753
541,42,42,3674335,3675018,700,3672804,3673589,740,3674329
542,36,36,3681061,3681644,600,3679613,3680403,652,3681055
543,58,58,3687871,3688820,965,3686422,3687217,647,3687864
544,54,54,3694896,3695779,900,3693248,3694031,859,3694890
545,46,46,3701589,3702338,766,3700058,3700845,738,3701583
546,18,18,3708415,3708698,300,3706867,3707659,750,3708409
547,20,20,3715191,3715507,333,3713676,3714473,712,3715185
548,36,36,3722034,3722616,599,3720502,3721287,740,3722027
549,28,28,3729043,3729492,466,3727311,3728101,935,3729036
550,56,56,3735536,3736451,932,3734121,3734915,615,3735530
551,50,50,3742628,3743444,833,3740947,3741729,893,3742622
552,34,34,3749437,3749987,566,3747756,3748543,888,3749431
553,40,40,3756113,3756763,666,3754565,3755357,750,3756107
554,26,26,3762790,3763206,432,3761374,3762171,612,3762783
555,16,16,3769782,3770032,266,3768200,3768985,790,3769775
556,20,20,3776575,3776891,333,3775010,3775799,770,3776569
557,46,46,3783600,3784350,766,3781819,3782613,981,3783594
558,24,24,3790293,3790676,400,3788628,3789427,860,3790287
559,34,34,3797152,3797702,566,3795454,3796241,905,3797146
560,8,8,3803595,3803712,134,3802263,3803055,533,3803588
561,2,2,3810754,3810771,34,3809073,3809869,879,3810748
562,18,18,3817347,3817630,300,3815899,3816683,658,3817341
563,36,36,3824290,3824872,599,3822708,3823497,786,3824283
564,48,48,3831066,3831848,799,3829517,3830311,748,3831059
565,58,58,3837858,3838807,966,3836326,3837125,726,3837851
566,2,2,3844518,3844534,33,3843152,3843939,572,3844511
567,12,12,3851577,3851760,199,3849962,3850753,818,3851571
568,36,36,3858203,3858785,599,3856771,3857567,629,3858196
569,58,58,3865162,3866111,966,3863597,3864381,775,3865156
570,32,32,3871921,3872437,533,3870406,3871195,720,3871915
571,22,22,3878830,3879180,367,3877216,3878009,816,3878825
572,48,48,3885623,3886406,799,3884025,3884823,794,3885617
573,4,4,3892316,3892366,66,3890851,3891637,673,3892310
574,54,54,3899108,3899991,899,3897660,3898451,651,3899102
575,30,30,3906101,3906584,499,3904469,3905265,829,3906094
576,42,42,3913060,3913743,699,3911295,3912079,975,3913054
577,10,10,3919553,3919703,166,3918105,3918893,654,3919547
578,4,4,3926445,3926495,67,3924914,3925707,732,3926439
579,46,46,3933188,3933937,766,3931723,3932521,661,3933182
580,6,6,3940131,3940214,100,3938549,3939335,789,3940124
581,28,28,3946740,3947190,466,3945358,3946149,584,3946733
582,60,60,3953783,3954765,998,3952168,3952963,814,3953777
583,2,2,3960442,3960459,33,3958994,3959777,659,3960436
584,28,28,3967551,3968000,466,3965803,3966591,954,3967545
585,30,30,3973911,3974394,499,3972612,3973405,499,3973904
586,40,40,3980820,3981469,666,3979421,3980219,594,3980813
587,48,48,3987846,3988628,799,3986247,3987033,806,3987839
588,38,38,3994705,3995321,632,3993057,3993847,852,3994699
589,4,4,4001298,4001348,66,3999866,4000661,630,4001291
590,38,38,4008174,4008790,632,4006692,4007475,692,4008167
591,12,12,4014816,4014999,200,4013501,4014289,521,4014810
592,10,10,4021875,4022025,167,4020310,4021103,766,4021869
593,40,40,4028535,4029184,666,4027120,4027917,612,4028529
594,26,26,4035494,4035910,433,4033946,4034731,757,4035488
595,14,14,4042253,4042470,233,4040755,4041545,702,4042247
596,2,2,4049079,4049096,34,4047564,4048359,714,4049073
597,20,20,4055938,4056255,333,4054390,4055173,759,4055932
598,40,40,4062964,4063613,666,4061199,4061987,971,4062958
599,4,4,4069674,4069723,66,4068009,4068801,867,4069668
600,22,22,4076533,4076882,366,4074818,4075615,912,4076527
601,16,16,4083109,4083359,266,4081644,4082429,674,4083103
602,54,54,4090118,4091000,899,4088453,4089243,869,4090112
603,4,4,4096911,4096961,66,4095262,4096057,847,4096904
604,58,58,4103470,4104419,966,4102088,4102871,592,4103463
605,34,34,4110379,4110929,567,4108898,4109685,688,4110373
606,42,42,4117006,4117688,699,4115707,4116499,500,4116999
607,40,40,4124164,4124814,666,4122516,4123313,845,4124158
608,14,14,4131024,4131240,233,4129342,4130127,890,4131017
609,4,4,4137633,4137683,67,4136151,4136941,685,4137626
610,32,32,4144709,4145225,533,4142961,4143755,948,4144703
611,28,28,4151502,4151951,466,4149770,4150569,926,4151495
612,40,40,4158261,4158910,666,4156596,4157383,872,4158255
613,42,42,4165120,4165803,699,4163405,4164197,917,4165114
614,58,58,4171613,4172562,966,4170215,4171011,596,4171607
615,10,10,4178772,4178922,166,4177041,4177825,941,4178766
616,10,10,4185348,4185498,167,4183850,4184639,703,4185342
617,16,16,4192191,4192440,266,4190659,4191453,731,4192184
618,42,42,4198800,4199483,700,4197468,4198267,526,4198793
619,18,18,4205876,4206159,300,4204294,4205081,788,4205869
620,48,48,4212402,4213185,799,4211104,4211895,501,4212396
621,10,10,4219611,4219761,167,4217913,4218709,896,4219605
622,14,14,4226470,4226687,233,4224739,4225523,941,4226464
623,42,42,4232930,4233613,699,4231548,4232337,586,4232923
624,24,24,4239689,4240072,400,4238357,4239151,531,4239682
625,40,40,4246499,4247148,666,4245167,4245965,527,4246492
626,36,36,4253541,4254124,599,4251993,4252779,756,4253535
627,32,32,4260134,4260650,533,4258802,4259593,534,4260127
628,38,38,4267276,4267892,633,4265611,4266407,863,4267270
629,38,38,4274035,4274651,633,4272437,4273221,808,4274029
630,14,14,4280845,4281061,233,4279246,4280035,803,4280838
631,36,36,4287754,4288337,599,4286056,4286849,899,4287748
632,28,28,4294463,4294913,466,4292865,4293663,794,4294457
633,22,22,4301256,4301605,366,4299691,4300477,773,4301250
634,48,48,4308098,4308881,800,4306500,4307291,801,4308092
635,4,4,4314608,4314658,67,4313309,4314105,496,4314601
636,12,12,4321700,4321883,200,4320135,4320919,775,4321694
637,46,46,4328643,4329392,766,4326945,4327733,904,4328637
638,44,44,4335419,4336135,732,4333754,4334547,866,4335413
639,58,58,4342195,4343144,965,4340563,4341361,827,4342188
640,2,2,4349054,4349071,33,4347389,4348175,873,4349048
641,20,20,4355980,4356296,333,4354198,4354989,984,4355973
642,12,12,4362306,4362489,200,4361008,4361803,497,4362300
643,22,22,4369232,4369582,366,4367834,4368617,609,4369226
644,28,28,4376075,4376524,466,4374643,4375431,637,4376068
645,8,8,4383084,4383200,133,4381452,4382245,832,4383077
646,36,36,4389677,4390259,599,4388262,4389059,612,4389671
647,56,56,4396453,4397368,932,4395087,4395873,573,4396446
648,44,44,4403378,4404094,733,4401897,4402687,685,4403372
649,32,32,4410171,4410687,533,4408706,4409501,664,4410165
650,42,42,4417014,4417696,699,4415532,4416315,692,4417007
651,22,22,4423840,4424189,366,4422341,4423129,704,4423833
652,58,58,4430832,4431781,966,4429151,4429943,883,4430826
653,48,48,4437658,4438440,799,4435960,4436757,895,4437652
654,14,14,4444068,4444284,233,4442786,4443571,490,4444061
655,22,22,4451243,4451593,367,4449595,4450385,852,4451237
656,20,20,4457253,4457570,333,4456404,4456416,830,4457246
657,22,22,4463730,4464079,366,4462431,4463230,493,4463723
658,36,36,4471038,4471621,600,4469257,4470044,988,4471032
659,18,18,4477515,4477798,299,4476066,4476858,650,4477508
660,44,44,4484324,4485040,733,4482876,4483672,646,4484318
661,30,30,4491317,4491799,499,4489702,4490486,825,4491311
662,46,46,4498292,4499041,766,4496511,4497300,986,4498286
663,42,42,4504635,4505318,700,4503320,4504114,515,4504629
664,26,26,4511445,4511861,433,4510129,4510928,510,4511438
665,46,46,4518537,4519286,766,4516955,4517742,788,4518530
666,52,52,4525180,4526029,866,4523765,4524556,618,4525174
667,4,4,4532255,4532305,67,4530574,4531370,879,4532249
668,16,16,4538948,4539198,267,4537400,4538184,758,4538942
669,24,24,4545558,4545941,399,4544209,4544998,553,4545551
670,14,14,4552450,4552667,233,4551018,4551812,631,4552443
671,52,52,4559359,4560208,866,4557828,4558626,727,4559353
672,20,20,4566002,4566319,333,4564654,4565440,556,4565996
673,34,34,4572795,4573344,566,4571463,4572254,534,4572788
674,20,20,4579637,4579954,333,4578272,4579068,563,4579631
675,52,52,4586746,4587595,866,4585098,4585882,858,4586740
676,46,46,4593689,4594438,766,4591907,4592696,986,4593682
677,58,58,4600182,4601131,965,4598717,4599510,666,4600176
678,14,14,4607108,4607324,233,4605526,4606324,777,4607101
679,22,22,4614017,4614366,366,4612352,4613138,873,4614011
680,56,56,4620760,4621675,932,4619161,4619952,801,4620753
681,18,18,4627619,4627902,299,4625971,4626766,847,4627613
682,12,12,4634212,4634395,199,4632796,4633580,625,4634205
683,20,20,4641171,4641487,333,4639606,4640394,771,4641165
684,60,60,4647780,4648763,999,4646415,4647208,566,4647774
685,54,54,4654590,4655472,899,4653224,4654022,561,4654583
686,16,16,4661382,4661632,267,4660050,4660836,539,4661375
687,36,36,4668624,4669207,600,4666860,4667650,969,4668619
688,48,48,4674984,4675767,799,4673669,4674464,514,4674978
689,40,40,4682260,4682909,665,4680495,4681278,976,4682254
690,46,46,4688703,4689452,765,4687304,4688092,604,4688696
691,22,22,4695645,4695995,366,4694113,4694906,732,4695638
692,36,36,4702304,4702887,600,4700923,4701720,578,4702298
693,48,48,4709047,4709830,799,4707749,4708534,507,4709041
694,34,34,4716106,4716656,566,4714558,4715348,752,4716100
695,44,44,4722682,4723398,733,4721367,4722162,514,4722676
696,30,30,4729492,4729974,499,4728193,4728976,509,4729485
697,16,16,4736701,4736950,266,4735002,4735790,904,4736694
698,28,28,4743243,4743693,467,4741812,4742604,633,4743237
699,8,8,4750169,4750286,133,4748621,4749418,745,4750163
700,4,4,4757212,4757262,66,4755447,4756232,974,4757206
701,4,4,4763988,4764038,66,4762256,4763046,935,4763981
702,60,60,4770664,4771646,999,4769065,4769860,797,4770657
703,58,58,4777623,4778572,965,4775891,4776674,942,4777616
704,10,10,4784482,4784632,167,4782701,4783488,988,4784476
705,36,36,4790908,4791491,600,4789510,4790302,600,4790902
706,34,34,4798051,4798600,566,4796319,4797116,928,4798044
707,12,12,4804927,4805110,199,4803145,4803930,990,4804920
708,2,2,4811686,4811703,33,4809954,4810744,935,4811679
709,46,46,4818528,4819278,766,4816764,4817558,965,4818523
710,12,12,4825238,4825421,200,4823573,4824372,860,4825232
711,38,38,4831897,4832513,633,4830399,4831186,705,4831891
712,8,8,4838523,4838640,134,4837208,4838000,517,4838517
713,52,52,4845483,4846332,865,4844018,4844814,663,4845477
714,24,24,4852475,4852858,400,4850843,4851628,840,4852468
715,42,42,4859318,4860000,699,4857653,4858442,870,4859312
716,48,48,4865894,4866676,799,4864462,4865256,631,4865887
717,8,8,4873036,4873153,133,4871271,4872070,960,4873030
718,56,56,4879546,4880461,932,4878097,4878884,655,4879539
719,56,56,4886455,4887371,932,4884907,4885698,751,4886449
720,44,44,4893181,4893897,732,4891716,4892512,663,4893175
721,6,6,4899907,4899990,100,4898542,4899326,575,4899901
722,24,24,4906899,4907282,400,4905351,4906140,753,4906893
723,28,28,4913642,4914092,466,4912160,4912954,681,4913635
724,32,32,4920451,4920967,533,4918970,4919768,677,4920445
725,8,8,4927077,4927194,134,4925796,4926582,489,4927071
726,34,34,4934270,4934819,566,4932605,4933396,868,4934264
727,56,56,4941079,4941995,932,4939414,4940210,863,4941073
728,50,50,4947639,4948454,832,4946240,4947024,608,4947632
729,14,14,4954781,4954997,233,4953049,4953838,936,4954774
730,18,18,4961257,4961540,300,4959859,4960652,599,4961251
731,16,16,4968433,4968682,266,4966668,4967466,961,4968427
732,26,26,4974809,4975225,433,4973494,4974280,523,4974803
733,52,52,4982051,4982900,866,4980303,4981094,951,4982045
734,54,54,4988761,4989643,899,4987112,4987908,846,4988754
735,14,14,4995220,4995437,233,4993938,4994722,491,4995213
736,4,4,5002462,5002512,67,5000748,5001536,921,5002457
737,20,20,5008972,5009288,333,5007557,5008350,616,5008966
738,4,4,5015781,5015831,67,5014366,5015164,611,5015775
739,24,24,5022857,5023240,400,5021192,5021978,873,5022851
740,14,14,5029533,5029750,233,5028001,5028792,734,5029526
741,50,50,5036426,5037241,832,5034811,5035606,814,5036420
742,4,4,5043052,5043102,66,5041637,5042420,626,5043046
743,46,46,5049745,5050494,765,5048446,5049234,504,5049738
744,54,54,5056937,5057819,899,5055255,5056048,882,5056930
745,4,4,5063530,5063580,66,5062065,5062862,662,5063524
746,42,42,5070389,5071071,699,5068890,5069676,706,5070382
747,58,58,5077481,5078430,966,5075700,5076490,985,5077475
748,40,40,5083808,5084457,666,5082509,5083304,497,5083801
749,14,14,5091083,5091299,233,5089335,5090118,959,5091077
750,58,58,5097826,5098775,965,5096144,5096932,887,5097819
751,50,50,5104269,5105085,832,5102954,5103746,517,5104263
752,36,36,5111161,5111744,600,5109763,5110560,595,5111155
753,26,26,5117921,5118337,433,5116589,5117374,540,5117914
754,56,56,5124880,5125795,932,5123398,5124188,685,5124873
755,24,24,5131989,5132372,399,5130207,5131002,980,5131982
756,52,52,5138748,5139597,866,5137033,5137816,926,5138742
757,30,30,5145374,5145857,500,5143843,5144630,738,5145368
758,16,16,5152067,5152317,266,5150652,5151444,617,5152061
759,2,2,5159126,5159143,33,5157461,5158258,862,5159120
760,52,52,5165952,5166801,866,5164287,5165072,874,5165946
761,42,42,5172561,5173244,700,5171096,5171886,669,5172555
762,24,24,5179421,5179804,399,5177906,5178700,715,5179415
763,46,46,5186247,5186996,765,5184732,5185514,727,5186241
764,34,34,5192906,5193455,566,5191541,5192328,572,5192900
765,60,60,5200098,5201080,999,5198350,5199142,950,5200092
766,24,24,5206558,5206941,399,5205159,5205956,595,5206551
767,60,60,5213650,5214632,999,5211985,5212770,874,5213644
768,2,2,5220176,5220193,34,5218795,5219584,586,5220170
769,42,42,5226952,5227635,700,5225604,5226398,548,5226946
770,18,18,5234145,5234428,299,5232413,5233212,926,5234138
771,10,10,5240771,5240921,166,5239239,5240026,738,5240764
772,54,54,5247730,5248612,899,5246048,5246840,883,5247723
773,8,8,5254339,5254456,134,5252858,5253654,679,5254333
774,56,56,5261132,5262048,932,5259684,5260468,658,5261126
775,22,22,5268258,5268607,366,5266493,5267282,970,5268252
776,2,2,5274834,5274851,33,5273302,5274096,731,5274827
777,58,58,5281910,5282858,965,5280111,5280910,993,5281903
778,48,48,5288419,5289202,799,5286937,5287724,688,5288412
779,40,40,5295428,5296078,666,5293747,5294538,884,5295422
780,6,6,5301921,5302004,100,5300556,5301352,563,5301915
781,36,36,5308780,5309363,600,5307382,5308166,608,5308774
782,10,10,5315505,5315655,167,5314190,5314980,519,5315499
783,48,48,5322798,5323580,799,5320999,5321794,997,5322791
784,44,44,5328641,5329357,733,5327825,5327825,809,5328634
785,52,52,5335467,5336316,866,5333852,5334639,822,5335461
786,30,30,5342193,5342676,500,5340662,5341453,734,5342187
787,14,14,5349202,5349419,233,5347471,5348267,929,5349196
788,52,52,5355629,5356478,865,5354297,5355081,541,5355622
789,58,58,5362854,5363803,966,5361106,5361895,953,5362848
790,22,22,5369663,5370013,367,5367915,5368709,948,5369657
791,40,40,5376073,5376722,666,5374725,5375523,544,5376067
792,46,46,5383265,5384015,766,5381551,5382337,923,5383260
793,32,32,5389975,5390491,532,5388360,5389151,818,5389969
794,60,60,5396618,5397600,998,5395169,5395965,646,5396611
795,4,4,5403327,5403377,67,5401995,5402779,541,5403320
796,44,44,5410169,5410885,733,5408804,5409593,570,5410163
797,16,16,5417045,5417295,267,5415614,5416407,632,5417039
798,34,34,5423938,5424487,566,5422423,5423221,711,5423932
799,22,22,5430880,5431230,367,5429249,5430035,839,5430874
800,48,48,5437790,5438572,799,5436058,5436849,934,5437783
801,44,44,5444399,5445115,733,5442867,5443663,729,5444392
802,18,18,5451342,5451625,299,5449693,5450477,858,5451335
803,20,20,5457934,5458251,333,5456503,5457291,637,5457928
804,58,58,5464610,5465559,966,5463312,5464105,499,5464604
805,12,12,5471486,5471669,200,5470121,5470919,561,5471480
806,20,20,5478495,5478812,333,5476947,5477733,756,5478489
807,16,16,5485438,5485688,266,5483756,5484547,884,5485431
808,50,50,5492347,5493163,833,5490566,5491361,980,5492341
809,32,32,5498973,5499489,533,5497392,5498175,792,5498967
810,28,28,5505533,5505982,466,5504201,5504989,537,5505526
811,42,42,5512325,5513008,700,5511010,5511803,516,5512319
812,34,34,5519351,5519901,566,5517819,5518617,727,5519344
813,58,58,5526427,5527376,965,5524645,5525431,989,5526420
814,46,46,5533153,5533902,766,5531455,5532245,902,5533147
815,6,6,5539995,5540079,100,5538264,5539059,930,5539989
816,20,20,5546655,5546971,333,5545090,5545873,776,5546649
817,2,2,5553264,5553281,34,5551899,5552687,571,5553258
818,52,52,5560190,5561039,866,5558708,5559501,682,5560183
819,6,6,5567133,5567216,100,5565518,5566315,812,5567127
820,20,20,5574042,5574358,333,5572344,5573129,907,5574036
821,58,58,5580735,5581684,965,5579153,5579943,785,5580728
822,46,46,5587294,5588043,766,5585962,5586757,530,5587287
823,20,20,5594237,5594553,333,5592788,5593571,659,5594230
824,2,2,5601379,5601396,33,5599597,5600385,987,5601372
825,10,10,5607839,5607988,166,5606407,5607199,633,5607832
826,8,8,5614665,5614781,133,5613216,5614013,645,5614658
827,36,36,5621524,5622106,599,5620042,5620827,690,5621517
828,42,42,5627700,5628383,700,5626851,5626858,835,5627693
829,24,24,5634426,5634809,400,5632878,5633672,748,5634420
830,26,26,5641036,5641452,433,5639687,5640486,543,5641029
831,24,24,5648145,5648528,399,5646513,5647300,838,5648138
832,40,40,5655004,5655653,666,5653323,5654114,884,5654998
833,58,58,5661747,5662696,965,5660132,5660928,813,5661741
834,38,38,5668356,5668972,633,5666958,5667742,608,5668350
835,36,36,5675232,5675815,600,5673767,5674556,670,5675226
836,58,58,5682208,5683157,966,5680576,5681370,831,5682201
837,8,8,5689117,5689234,133,5687386,5688184,927,5689111
838,8,8,5695876,5695993,134,5694212,5694998,873,5695871
839,50,50,5702786,5703601,832,5701021,5701812,968,5702780
840,12,12,5709162,5709345,200,5707830,5708626,529,5709155
841,54,54,5715971,5716854,899,5714656,5715440,525,5715965
842,38,38,5723147,5723763,633,5721465,5722254,886,5723140
843,60,60,5729806,5730789,999,5728275,5729068,732,5729800
844,26,26,5736632,5737049,433,5735084,5735882,744,5736626
845,16,16,5743492,5743741,266,5741910,5742696,789,5743485
846,20,20,5750501,5750817,333,5748719,5749510,984,5750494
847,24,24,5756894,5757277,399,5755528,5756324,563,5756887
848,14,14,5764036,5764252,233,5762354,5763138,891,5764029
849,22,22,5770912,5771261,366,5769164,5769952,954,5770906
850,26,26,5777438,5777854,433,5775973,5776766,666,5777432
851,22,22,5784347,5784697,367,5782782,5783580,761,5784341
852,28,28,5791256,5791706,467,5789608,5790394,856,5791250
853,8,8,5798032,5798149,134,5796417,5797208,818,5798026
854,46,46,5804675,5805424,766,5803227,5804022,647,5804669
855,56,56,5811584,5812500,933,5810053,5810836,742,5811578
856,8,8,5818260,5818377,134,5816862,5817650,604,5818254
857,36,36,5825436,5826019,599,5823671,5824464,966,5825430
858,24,24,5831929,5832312,400,5830481,5831278,645,5831923
859,30,30,5838971,5839454,500,5837306,5838092,873,5838965
860,36,36,5845481,5846064,599,5844116,5844906,569,5845475
861,26,26,5852290,5852706,433,5850925,5851720,564,5852284
862,34,34,5859416,5859965,566,5857751,5858534,876,5859410
863,36,36,5866025,5866608,600,5864560,5865348,671,5866019
864,38,38,5872735,5873351,632,5871370,5872162,567,5872729
865,30,30,5879844,5880327,499,5878179,5878976,862,5879838
866,6,6,5886703,5886786,100,5885005,5885790,907,5886697
867,2,2,5893462,5893479,34,5891814,5892604,852,5893456
868,36,36,5900371,5900954,600,5898623,5899418,947,5900365
869,38,38,5906981,5907597,633,5905449,5906232,742,5906974
870,42,42,5913757,5914440,699,5912259,5913046,705,5913751
871,2,2,5920366,5920383,34,5919068,5919860,500,5920360
872,28,28,5927359,5927808,466,5925877,5926674,678,5927352
873,10,10,5934368,5934518,166,5932703,5933488,874,5934362
874,50,50,5941077,5941893,833,5939512,5940302,769,5941071
875,60,60,5947853,5948836,999,5946322,5947116,731,5947847
876,6,6,5954463,5954546,100,5953148,5953930,527,5954457
877,4,4,5961539,5961588,66,5959957,5960744,788,5961532
878,46,46,5968115,5968864,766,5966766,5967558,550,5968108
879,44,44,5975090,5975806,733,5973575,5974372,712,5975084
880,8,8,5981933,5982050,133,5980401,5981186,740,5981926
881,20,20,5988709,5989025,333,5987211,5988000,703,5988703
882,52,52,5995552,5996401,865,5994020,5994814,731,5995545
883,32,32,6002527,6003044,533,6000829,6001628,893,6002521
884,10,10,6009370,6009520,166,6007655,6008442,922,6009364
885,10,10,6015796,6015946,167,6014464,6015256,533,6015789
886,48,48,6022672,6023455,799,6021274,6022070,596,6022666
887,52,52,6029498,6030347,866,6028100,6028884,608,6029492
888,26,26,6036557,6036973,433,6034909,6035698,853,6036551
889,32,32,6043466,6043982,533,6041718,6042512,948,6043460
890,54,54,6049909,6050792,899,6048528,6049326,577,6049903
891,54,54,6056985,6057867,899,6055353,6056140,838,6056978
892,52,52,6063611,6064460,866,6062163,6062954,651,6063605
893,52,52,6070437,6071286,866,6068972,6069768,663,6070431
894,6,6,6077546,6077629,100,6075798,6076582,958,6077540
895,12,12,6084039,6084222,200,6082607,6083396,636,6084032
896,40,40,6090898,6091548,666,6089417,6090210,682,6090892
897,50,50,6097907,6098723,833,6096226,6097024,877,6097901
898,20,20,6104800,6105116,333,6103052,6103838,956,6104794
899,8,8,6111576,6111692,133,6109861,6110652,918,6111570
900,6,6,6118369,6118452,99,6116670,6117466,896,6118362
901,52,52,6125061,6125910,866,6123496,6124280,775,6125055
902,2,2,6131970,6131987,34,6130306,6131094,871,6131965
903,22,22,6138613,6138963,367,6137115,6137908,699,6138607
904,34,34,6145356,6145905,566,6143924,6144722,627,6145349
905,34,34,6152115,6152665,566,6150750,6151536,573,6152109
906,4,4,6159024,6159074,67,6157559,6158350,668,6159018
907,42,42,6166034,6166716,699,6164369,6165164,864,6166028
908,54,54,6172793,6173675,899,6171195,6171978,809,6172787
909,26,26,6179552,6179968,433,6178004,6178792,754,6179546
910,58,58,6186278,6187227,966,6184813,6185606,666,6186272
911,14,14,6193121,6193337,233,6191622,6192420,694,6193114
912,32,32,6200047,6200563,532,6198448,6199234,806,6200040
913,26,26,6206889,6207305,433,6205258,6206048,835,6206883
914,12,12,6213798,6213982,200,6212067,6212862,930,6213792
915,14,14,6220541,6220758,233,6218893,6219676,859,6220535
916,8,8,6227284,6227400,133,6225702,6226490,787,6227277
917,56,56,6233943,6234859,933,6232511,6233304,632,6233936
918,22,22,6240753,6241102,366,6239321,6240118,628,6240746
919,44,44,6247545,6248261,733,6246147,6246932,607,6247539
920,40,40,6254621,6255270,666,6252956,6253746,869,6254615
921,48,48,6261230,6262013,799,6259765,6260560,664,6261224
922,22,22,6268206,6268556,366,6266591,6267374,826,6268200
923,52,52,6274882,6275731,866,6273400,6274188,687,6274875
924,2,2,6281791,6281808,34,6280210,6281002,783,6281785
925,8,8,6288767,6288884,133,6287019,6287816,945,6288761
926,32,32,6295243,6295760,533,6293845,6294630,607,6295237
927,44,44,6302069,6302785,733,6300654,6301444,619,6302063
928,46,46,6308795,6309545,766,6307464,6308258,531,6308789
929,42,42,6315954,6316637,700,6314289,6315072,876,6315948
930,36,36,6322847,6323430,599,6321099,6321886,955,6322841
931,16,16,6329423,6329673,266,6327908,6328700,717,6329417
932,56,56,6336266,6337181,932,6334717,6335514,745,6336259
933,10,10,6343191,6343341,167,6341543,6342328,857,6343185
934,22,22,6349768,6350117,366,6348353,6349142,620,6349762
935,58,58,6356893,6357842,966,6355162,6355956,931,6356887
936,42,42,6363453,6364135,699,6361971,6362770,676,6363446
937,18,18,6370196,6370479,299,6368797,6369584,605,6370189
938,32,32,6377188,6377704,533,6375606,6376398,783,6377181
939,52,52,6383814,6384663,866,6382416,6383212,596,6383808
940,36,36,6390590,6391173,599,6389242,6390026,558,6390584
941,8,8,6397449,6397566,134,6396051,6396840,603,6397443
942,52,52,6404342,6405191,866,6402860,6403654,681,6404335
943,38,38,6411384,6412000,633,6409669,6410468,910,6411378
944,2,2,6418077,6418094,33,6416495,6417282,788,6418070
945,6,6,6424920,6425003,99,6423305,6424096,818,6424914
946,56,56,6431696,6432611,932,6430114,6430910,779,6431689
947,54,54,6438655,6439537,899,6436940,6437724,925,6438649
948,14,14,6445198,6445414,233,6443749,6444538,653,6445191
949,58,58,6452173,6453122,966,6450558,6451352,815,6452167
950,34,34,6459099,6459649,566,6457368,6458166,927,6459093
951,50,50,6465609,6466425,832,6464194,6464980,623,6465603
952,24,24,6472518,6472901,400,6471003,6471794,718,6472512
953,18,18,6478328,6478611,300,6477812,6477825,496,6478321
954,18,18,6485221,6485504,300,6483856,6484639,576,6485215
955,4,4,6492330,6492380,66,6490665,6491453,871,6492324
956,50,50,6498906,6499722,832,6497474,6498267,632,6498899
957,2,2,6505782,6505799,33,6504284,6505081,695,6505776
958,26,26,6512608,6513024,433,6511109,6511895,706,6512601
959,12,12,6519534,6519717,199,6517919,6518709,819,6519528
960,20,20,6526226,6526543,333,6524728,6525523,697,6526220
961,6,6,6533102,6533186,100,6531554,6532337,759,6533096
962,60,60,6539995,6540977,999,6538363,6539151,837,6539988
963,14,14,6546022,6546238,233,6545173,6545182,833,6546015
964,60,60,6552598,6553580,999,6551199,6551996,595,6552591
965,2,2,6559457,6559474,33,6558025,6558810,640,6559450
966,36,36,6566183,6566766,599,6564835,6565624,553,6566177
967,40,40,6572959,6573608,666,6571644,6572438,515,6572953
968,8,8,6580218,6580334,133,6578453,6579252,960,6580212
969,6,6,6586994,6587077,100,6585279,6586066,922,6586988
970,42,42,6593786,6594469,700,6592088,6592880,900,6593780
971,50,50,6600446,6601262,832,6598898,6599694,746,6600440
972,52,52,6607438,6608287,866,6605724,6606508,925,6607433
973,16,16,6613931,6614181,267,6612533,6613322,603,6613925
974,60,60,6621040,6622023,999,6619342,6620136,898,6621034
975,40,40,6627517,6628166,666,6626151,6626950,560,6627510
976,48,48,6634326,6635108,799,6632977,6633764,555,6634319
977,6,6,6641535,6641618,100,6639787,6640578,951,6641529
978,12,12,6647928,6648111,200,6646596,6647392,529,6647921
979,38,38,6654737,6655353,633,6653422,6654206,525,6654731
980,16,16,6661929,6662179,267,6660231,6661020,903,6661923
981,24,24,6668389,6668772,400,6667040,6667834,548,6668382
982,6,6,6675431,6675515,100,6673850,6674648,777,6675425
983,56,56,6682424,6683339,932,6680676,6681462,956,6682418
984,28,28,6689266,6689716,467,6687485,6688276,984,6689260
985,36,36,6695843,6696425,599,6694294,6695090,746,6695836
986,56,56,6702902,6703817,932,6701120,6701904,991,6702895
987,56,56,6709361,6710277,933,6707929,6708718,636,6709354
988,52,52,6716487,6717336,866,6714739,6715532,949,6716481
989,40,40,6723230,6723879,665,6721548,6722346,877,6723223
990,10,10,6730122,6730272,167,6728374,6729160,956,6730116
991,42,42,6736831,6737514,700,6735183,6735974,851,6736825
992,30,30,6743757,6744240,500,6741993,6742788,964,6743752
993,58,58,6750184,6751133,965,6748818,6749602,575,6750177
994,24,24,6757359,6757742,400,6755628,6756416,937,6757353
995,60,60,6764119,6765101,998,6762437,6763230,882,6764112
996,18,18,6770678,6770961,300,6769246,6770044,627,6770671
997,58,58,6777820,6778769,966,6776072,6776858,956,6777814
998,48,48,6784213,6784996,800,6782882,6783672,535,6784207
999,34,34,6791322,6791872,566,6789691,6790486,830,6791316
1000,12,12,6798148,6798331,200,6796517,6797300,842,6798142
1001,40,40,6804741,6805390,666,6803326,6804114,621,6804735
1002,40,40,6811867,6812516,666,6810135,6810928,932,6811860
1003,50,50,6818609,6819425,833,6816945,6817742,862,6818604
1004,48,48,6825302,6826085,799,6823771,6824556,740,6825296
1005,38,38,6832295,6832911,632,6830580,6831370,919,6832289
1006,44,44,6838904,6839620,733,6837389,6838184,714,6838898
1007,52,52,6845780,6846629,866,6844215,6844998,776,6845774
1008,44,44,6852473,6853189,732,6851024,6851812,654,6852466
1009,32,32,6859215,6859732,533,6857834,6858626,583,6859209
1010,42,42,6865625,6866308,699,6864643,6864657,961,6865618
1011,56,56,6872218,6873134,932,6870686,6871471,740,6872211
1012,26,26,6878994,6879410,433,6877496,6878285,703,6878988
1013,16,16,6886036,6886286,267,6884305,6885099,931,6886030
1014,48,48,6892579,6893362,799,6891114,6891913,660,6892573
1015,2,2,6899705,6899722,33,6897940,6898727,972,6899699
1016,58,58,6906181,6907130,966,6904749,6905541,633,6906174
1017,26,26,6913157,6913573,433,6911559,6912355,796,6913151
1018,44,44,6919883,6920599,733,6918385,6919169,708,6919877
1019,60,60,6926709,6927691,999,6925194,6925983,720,6926703
1020,20,20,6933335,6933651,333,6932003,6932797,531,6933328
1021,44,44,6940494,6941210,733,6938813,6939611,877,6940488
1022,46,46,6947387,6948136,765,6945638,6946425,955,6947380
1023,40,40,6953796,6954446,666,6952448,6953239,551,6953790
1024,28,28,6960972,6961421,466,6959257,6960053,913,6960966
1025,26,26,6967615,6968031,432,6966083,6966867,741,6967608
1026,60,60,6974424,6975406,999,6972892,6973681,736,6974417
1027,38,38,6981083,6981699,633,6979702,6980495,582,6981077
1028,10,10,6988259,6988409,166,6986511,6987309,944,6988253
1029,60,60,6994735,6995717,999,6993337,6994123,606,6994729
1030,36,36,7001761,7002344,599,7000146,7000937,818,7001755
1031,36,36,7008537,7009120,599,7006955,7007751,779,7008530
1032,10,10,7015563,7015712,166,7013781,7014565,991,7015556
1033,54,54,7022089,7022971,899,7020591,7021379,704,7022083
1034,50,50,7028832,7029647,832,7027400,7028193,632,7028825
1035,8,8,7035941,7036057,133,7034209,7035007,927,7035934
1036,42,42,7042733,7043416,699,7041035,7041821,906,7042727
1037,28,28,7049459,7049909,466,7047844,7048635,818,7049453
1038,38,38,7056152,7056768,633,7054654,7055449,697,7056146
1039,40,40,7062761,7063411,666,7061480,7062263,492,7062755
1040,18,18,7070004,7070287,299,7068289,7069077,921,7069998
1041,54,54,7076763,7077645,899,7075098,7075891,866,7076757
1042,22,22,7083389,7083739,366,7081907,7082705,677,7083382
1043,18,18,7090248,7090531,300,7088733,7089519,723,7090242
1044,46,46,7097241,7097990,766,7095543,7096333,902,7097235
1045,18,18,7103834,7104117,299,7102352,7103147,680,7103827
1046,52,52,7110793,7111642,865,7109178,7109961,826,7110787
1047,50,50,7117685,7118501,833,7115987,7116775,904,7117679
1048,10,10,7124228,7124378,167,7122796,7123589,632,7124221
1049,58,58,7130921,7131870,966,7129606,7130403,512,7130915
1050,56,56,7136998,7137913,932,7136432,7136434,557,7136991
1051,2,2,7143840,7143857,34,7142458,7143248,585,7143833
1052,58,58,7150783,7151732,965,7149268,7150062,715,7150777
1053,6,6,7157509,7157592,100,7156077,7156876,626,7157502
1054,24,24,7164285,7164668,399,7162903,7163690,588,7164278
1055,60,60,7171094,7172076,999,7169712,7170504,583,7171087
1056,44,44,7178270,7178985,732,7176522,7177318,946,7178264
1057,14,14,7185112,7185329,233,7183347,7184132,974,7185106
1058,48,48,7191672,7192454,799,7190157,7190946,720,7191666
1059,50,50,7198315,7199130,832,7196966,7197760,548,7198308
1060,52,52,7205340,7206189,866,7203775,7204574,760,7205334
1061,22,22,7212249,7212599,367,7210601,7211388,855,7212243
1062,32,32,7218792,7219308,533,7217411,7218202,584,7218786
1063,58,58,7225668,7226617,966,7224220,7225016,646,7225662
1064,2,2,7232810,7232827,34,7231046,7231830,975,7232805
1065,38,38,7239520,7240136,633,7237855,7238644,870,7239514
1066,38,38,7245980,7246596,632,7244664,7245458,515,7245973
1067,48,48,7253105,7253888,799,7251474,7252272,827,7253099
1068,6,6,7259881,7259964,100,7258300,7259086,789,7259875
1069,32,32,7266424,7266940,533,7265109,7265900,518,7266418
1070,4,4,7273716,7273766,67,7271918,7272714,996,7273710
1071,28,28,7280126,7280575,466,7278744,7279528,591,7280119
1072,14,14,7287118,7287335,233,7285553,7286342,770,7287112
1073,16,16,7293911,7294161,266,7292363,7293156,749,7293905
1074,22,22,7300670,7301020,367,7299172,7299970,694,7300664
1075,50,50,7307646,7308462,832,7305998,7306784,856,7307640
1076,8,8,7314522,7314638,133,7312807,7313598,918,7314516
1077,26,26,7321398,7321814,433,7319616,7320412,979,7321391
1078,4,4,7327808,7327857,66,7326442,7327226,575,7327801
1079,42,42,7334867,7335549,699,7333252,7334040,821,7334861
1080,42,42,7341692,7342375,700,7340061,7340854,832,7341686
1081,54,54,7348369,7349251,899,7346870,7347668,694,7348362
1082,22,22,7355211,7355561,366,7353696,7354482,723,7355205
1083,28,28,7362287,7362736,466,7360505,7361296,984,7362280
1084,56,56,7368996,7369912,933,7367315,7368110,880,7368990
1085,32,32,7375722,7376238,533,7374141,7374924,792,7375716
1086,50,50,7382615,7383431,832,7380950,7381738,871,7382609
1087,42,42,7389174,7389857,700,7387759,7388552,616,7389168
1088,22,22,7396200,7396550,366,7394568,7395366,827,7396193
1089,12,12,7402909,7403093,200,7401394,7402180,723,7402903
1090,18,18,7409685,7409968,300,7408204,7408994,685,7409679
1091,46,46,7416794,7417544,766,7415013,7415808,980,7416788
1092,34,34,7423154,7423704,566,7421839,7422622,526,7423148
1093,36,36,7430296,7430879,600,7428648,7429436,854,7430290
1094,36,36,7436856,7437439,599,7435457,7436250,599,7436849
1095,52,52,7443982,7444831,865,7442267,7443064,912,7443976
1096,26,26,7450591,7451007,433,7449093,7449878,707,7450585
1097,26,26,7457667,7458083,433,7455902,7456692,969,7457661
1098,54,54,7464476,7465358,899,7462711,7463506,964,7464470
1099,50,50,7470902,7471718,833,7469537,7470320,576,7470896
1100,12,12,7478028,7478211,200,7476347,7477134,888,7478022
1101,4,4,7484638,7484687,66,7483156,7483948,683,7484631
1102,2,2,7491397,7491413,33,7489965,7490762,628,7491390
1103,8,8,7498323,7498439,133,7496791,7497576,740,7498316
1104,2,2,7505282,7505298,33,7503600,7504390,885,7505275
1105,8,8,7512074,7512191,134,7510410,7511204,865,7512069
1106,42,42,7518950,7519633,700,7517236,7518018,927,7518945
1107,12,12,7525343,7525527,200,7524045,7524832,505,7525337
1108,20,20,7532569,7532885,333,7530854,7531646,917,7532563
1109,8,8,7539162,7539278,133,7537663,7538460,695,7539155
1110,28,28,7545854,7546304,467,7544489,7545274,574,7545848
1111,60,60,7553063,7554046,999,7551299,7552088,970,7553058
1112,46,46,7559789,7560539,766,7558108,7558902,881,7559783
1113,30,30,7566665,7567148,500,7564917,7565716,943,7566659
1114,26,26,7573158,7573574,433,7571743,7572530,622,7573152
1115,48,48,7580334,7581116,799,7578552,7579344,983,7580327
1116,54,54,7586910,7587792,899,7585362,7586158,746,7586904
1117,30,30,7593619,7594102,500,7592188,7592972,641,7593613
1118,46,46,7600445,7601194,766,7598997,7599786,653,7600439
1119,24,24,7607171,7607554,400,7605806,7606600,565,7607165
1120,18,18,7613914,7614197,300,7612615,7613414,493,7613907
1121,32,32,7621189,7621706,533,7619441,7620228,955,7621183
1122,28,28,7627832,7628282,466,7626251,7627042,784,7627826
1123,24,24,7634642,7635024,399,7633060,7633856,779,7634635
1124,32,32,7641517,7642034,533,7639886,7640670,841,7641511
1125,6,6,7648460,7648543,100,7646695,7647484,970,7648454
1126,12,12,7654986,7655169,200,7653504,7654298,681,7654979
1127,20,20,7661862,7662178,333,7660314,7661112,744,7661856
1128,56,56,7668522,7669437,932,7667140,7667926,589,7668515
1129,40,40,7675597,7676246,666,7673949,7674740,851,7675591
1130,20,20,7682223,7682540,333,7680758,7681554,663,7682217
1131,22,22,7689299,7689649,366,7687584,7688368,925,7689293
1132,10,10,7695725,7695875,167,7694393,7695182,536,7695718
1133,58,58,7702968,7703916,965,7701203,7701996,966,7702962
1134,32,32,7709510,7710027,533,7708012,7708810,694,7709504
1135,18,18,7716353,7716636,300,7714838,7715624,723,7716347
1136,36,36,7723229,7723812,599,7721647,7722438,784,7723222
1137,2,2,7730105,7730121,33,7728457,7729252,847,7730099
1138,38,38,7736714,7737330,633,7735282,7736066,641,7736707
1139,34,34,7743790,7744339,566,7742092,7742880,904,7743784
1140,56,56,7750566,7751482,932,7748901,7749694,866,7750560
1141,4,4,7757409,7757458,66,7755710,7756508,894,7757402
1142,24,24,7764001,7764384,400,7762536,7763322,673,7763995
1143,42,42,7770861,7771543,699,7769346,7770136,719,7770855
1144,50,50,7777903,7778719,832,7776155,7776950,947,7777897
1145,54,54,7784446,7785328,899,7782981,7783764,676,7784440
1146,48,48,7791422,7792204,799,7789790,7790578,837,7791415
1147,18,18,7797931,7798214,300,7796599,7797392,532,7797924
1148,28,28,7805040,7805490,466,7803409,7804206,828,7805034
1149,44,44,7811983,7812699,732,7810235,7811020,957,7811977
1150,14,14,7818759,7818975,233,7817044,7817834,919,7818753
1151,38,38,7825418,7826034,633,7823853,7824648,764,7825412
1152,42,42,7832194,7832877,699,7830679,7831462,726,7832188
1153,30,30,7838904,7839386,499,7837488,7838276,621,7838897
1154,24,24,7845679,7846062,400,7844298,7845090,583,7845673
1155,58,58,7852422,7853371,966,7851107,7851904,512,7852416
1156,54,54,7859431,7860314,899,7857933,7858718,707,7859425
1157,46,46,7866474,7867223,765,7864742,7865532,935,7866467
1158,56,56,7873066,7873982,933,7871551,7872346,714,7873060
1159,50,50,7879859,7880675,833,7878377,7879160,692,7879852
1160,52,52,7886935,7887784,866,7885187,7885974,955,7886929
1161,44,44,7893361,7894077,733,7891996,7892788,567,7893355
1162,48,48,7900453,7901236,800,7898805,7899602,845,7900447
1163,20,20,7907296,7907612,333,7905631,7906416,874,7907290
1164,44,44,7914172,7914888,732,7912440,7913230,935,7914165
1165,48,48,7920565,7921347,799,7919250,7920044,515,7920559
1166,54,54,7927624,7928506,899,7926059,7926858,760,7927618
1167,28,28,7934333,7934783,467,7932885,7933672,655,7934327
1168,30,30,7941126,7941609,500,7939694,7940486,633,7941119
1169,24,24,7947802,7948185,400,7946504,7947300,496,7947796
1170,42,42,7955111,7955793,699,7953329,7954114,990,7955104
1171,48,48,7961754,7962536,799,7960139,7960928,820,7961748
1172,36,36,7968313,7968896,600,7966948,7967742,565,7968307
1173,24,24,7975073,7975455,399,7973757,7974556,510,7975066
1174,4,4,7982365,7982415,66,7980583,7981370,988,7982358
1175,56,56,7988724,7989640,933,7987393,7988184,534,7988718
1176,4,4,7995800,7995850,67,7994202,7994998,796,7995794
1177,40,40,8002443,8003092,666,8001028,8001812,625,8002437
1178,50,50,8009335,8010151,833,8007837,8008626,703,8009329
1179,34,34,8016245,8016794,566,8014646,8015440,798,8016238
1180,8,8,8023004,8023120,133,8021456,8022254,744,8022998
1181,32,32,8029896,8030413,533,8028282,8029068,823,8029891
1182,18,18,8036689,8036972,300,8035091,8035882,801,8036683
1183,52,52,8043448,8044298,866,8041900,8042696,746,8043442
1184,44,44,8050224,8050940,733,8048726,8049510,708,8050218
1185,50,50,8057267,8058083,832,8055535,8056324,936,8057260
1186,36,36,8064059,8064642,600,8062345,8063138,916,8064054
1187,14,14,8070835,8071052,234,8069154,8069952,877,8070829
1188,24,24,8077595,8077978,399,8075980,8076766,823,8077589
1189,26,26,8084537,8084953,433,8082789,8083580,951,8084531
1190,26,26,8091330,8091746,433,8089598,8090394,929,8091323
1191,16,16,8097773,8098023,266,8096424,8097208,558,8097766
1192,56,56,8104532,8105448,933,8103234,8104022,504,8104526
1193,6,6,8111824,8111908,100,8110043,8110836,982,8111818
1194,30,30,8118584,8119066,499,8116852,8117650,927,8118577
1195,30,30,8125027,8125509,499,8123678,8124464,556,8125020
1196,38,38,8132186,8132802,632,8130487,8131278,901,8132179
1197,2,2,8139012,8139028,33,8137297,8138092,914,8139006
1198,46,46,8145904,8146653,766,8144123,8144906,992,8145898
1199,10,10,8152564,8152713,166,8150932,8151720,837,8152557
1200,18,18,8159173,8159456,300,8157741,8158534,632,8159166
1201,50,50,8166182,8166998,833,8164551,8165348,828,8166176
1202,50,50,8173058,8173874,832,8171376,8172162,889,8173051
1203,46,46,8179884,8180633,766,8178186,8178976,902,8179878
1204,32,32,8186776,8187293,533,8184995,8185790,980,8186770
1205,38,38,8193286,8193902,633,8191821,8192604,676,8193280
1206,46,46,8200229,8200978,765,8198630,8199418,804,8200222
1207,40,40,8207021,8207670,666,8205440,8206232,783,8207015
1208,28,28,8213780,8214230,467,8212249,8213046,728,8213774
1209,56,56,8220806,8221722,933,8219075,8219860,940,8220800
1210,12,12,8227266,8227449,200,8225884,8226674,585,8227259
1211,52,52,8234441,8235290,866,8232693,8233488,947,8234435
1212,12,12,8241151,8241334,200,8239519,8240302,842,8241144
1213,2,2,8247744,8247760,33,8246329,8247116,622,8247738
1214,48,48,8254686,8255469,799,8253138,8253930,750,8254680
1215,44,44,8261429,8262145,732,8259947,8260744,678,8261422
1216,22,22,8268371,8268721,367,8266773,8267558,807,8268365
1217,18,18,8275081,8275364,299,8273582,8274372,702,8275074
1218,40,40,8282106,8282756,666,8280392,8281186,915,8282101
1219,32,32,8288949,8289465,533,8287218,8288000,943,8288943
1220,6,6,8295625,8295708,100,8294027,8294814,805,8295619
1221,12,12,8302551,8302734,200,8300836,8301628,917,8302545
1222,14,14,8308977,8309194,233,8307645,8308442,528,8308970
1223,24,24,8316236,8316619,400,8314471,8315256,974,8316230
1224,12,12,8322962,8323145,200,8321281,8322070,886,8322956
1225,60,60,8329405,8330387,999,8328090,8328884,515,8329399
1226,40,40,8336647,8337297,666,8334899,8335698,943,8336641
1227,32,32,8343323,8343839,533,8341725,8342512,805,8343317
1228,10,10,8349900,8350049,166,8348534,8349326,567,8349893
1229,26,26,8357108,8357525,433,8355344,8356140,963,8357103
1230,46,46,8363868,8364617,766,8362170,8362954,908,8363862
1231,42,42,8370744,8371426,699,8368979,8369768,970,8370738
1232,8,8,8377303,8377420,133,8375788,8376582,715,8377297
1233,8,8,8383929,8384046,134,8382597,8383396,526,8383922
1234,44,44,8390922,8391638,732,8389423,8390210,705,8390915
1235,12,12,8397981,8398164,200,8396233,8397024,951,8397975
1236,60,60,8404341,8405323,999,8403042,8403838,496,8404334
1237,18,18,8411499,8411783,300,8409868,8410652,841,8411493
1238,20,20,8418059,8418375,333,8416677,8417466,586,8418052
1239,48,48,8424868,8425651,799,8423486,8424280,581,8424861
1240,52,52,8431844,8432693,866,8430296,8431094,744,8431838
1241,30,30,8438603,8439086,500,8437122,8437908,689,8438597
1242,46,46,8445313,8446062,766,8443931,8444722,584,8445306
1243,38,38,8452455,8453071,633,8450740,8451536,913,8452449
1244,32,32,8459348,8459864,532,8457566,8458350,991,8459341
1245,48,48,8465841,8466623,799,8464376,8465164,671,8465835
1246,18,18,8472700,8472983,300,8471185,8471978,716,8472694
1247,42,42,8479476,8480158,699,8477994,8478792,677,8479469
1248,36,36,8486601,8487184,600,8484820,8485606,989,8486595
1249,26,26,8493211,8493627,433,8491629,8492420,784,8493204
1250,8,8,8500004,8500120,133,8498439,8499234,764,8499998
1251,42,42,8506646,8507329,700,8505265,8506048,592,8506640
1252,16,16,8513472,8513722,267,8512074,8512862,604,8513466
1253,6,6,8520465,8520548,100,8518883,8519676,782,8520458
1254,38,38,8527307,8527923,633,8525692,8526490,811,8527301
1255,14,14,8534067,8534283,233,8532518,8533304,756,8534060
1256,18,18,8540793,8541076,299,8539328,8540118,669,8540787
1257,14,14,8547918,8548135,233,8546137,8546932,980,8547912
1258,38,38,8554328,8554944,633,8552963,8553746,576,8554322
1259,22,22,8561504,8561853,366,8559772,8560560,937,8561497
1260,44,44,8568246,8568962,733,8566581,8567374,866,8568240
1261,58,58,8574889,8575838,966,8573391,8574188,695,8574883
1262,34,34,8581832,8582381,566,8580217,8581002,824,8581826
1263,56,56,8588391,8589307,932,8587026,8587816,569,8588385
1264,36,36,8595400,8595983,600,8593835,8594630,764,8595394
1265,38,38,8602376,8602992,633,8600661,8601444,926,8602370
1266,30,30,8609119,8609601,499,8607470,8608258,854,8609112
1267,48,48,8615795,8616577,799,8614280,8615072,717,8615789
1268,30,30,8622870,8623353,500,8621089,8621886,978,8622864
1269,44,44,8629663,8630379,733,8627915,8628700,957,8629657
1270,38,38,8636389,8637005,633,8634724,8635514,869,8636383
1271,60,60,8643015,8643997,999,8641533,8642328,680,8643008
1272,4,4,8650091,8650141,66,8648359,8649142,942,8650084
1273,30,30,8656684,8657167,499,8655169,8655956,722,8656678
1274,52,52,8663593,8664442,866,8661978,8662770,817,8663587
1275,46,46,8670386,8671135,765,8668787,8669584,795,8670379
1276,56,56,8677361,8678277,933,8675613,8676398,957,8677355
1277,32,32,8683921,8684437,533,8682422,8683212,702,8683914
1278,20,20,8690564,8690880,333,8689232,8690026,531,8690557
1279,26,26,8697573,8697989,433,8696041,8696840,726,8697566
1280,32,32,8704598,8705115,533,8702867,8703654,938,8704592
1281,2,2,8711358,8711374,33,8709676,8710468,883,8711351
1282,50,50,8718167,8718983,833,8716486,8717282,879,8718161
1283,46,46,8724677,8725426,766,8723311,8724096,574,8724670
1284,20,20,8731819,8732135,333,8730121,8730910,903,8731813
1285,4,4,8738495,8738545,67,8736930,8737724,765,8738489
1286,22,22,8745271,8745621,366,8743739,8744538,726,8745264
1287,48,48,8752014,8752796,799,8750565,8751352,655,8752007
1288,10,10,8758956,8759106,167,8757375,8758166,784,8758950
1289,6,6,8765782,8765865,100,8764184,8764980,796,8765776
1290,30,30,8772691,8773174,500,8771010,8771794,891,8772685
1291,4,4,8778468,8778518,67,8777819,8777825,636,8778461
1292,38,38,8785427,8786043,633,8783846,8784639,782,8785421
1293,52,52,8792387,8793236,865,8790655,8791453,927,8792380
1294,6,6,8798930,8799013,99,8797481,8798267,656,8798923
1295,46,46,8806022,8806771,766,8804290,8805081,934,8806015
1296,18,18,8812848,8813131,299,8811100,8811895,947,8812842
1297,32,32,8819441,8819957,532,8817926,8818709,726,8819435
1298,38,38,8826416,8827032,633,8824735,8825523,887,8826410
1299,30,30,8833092,8833575,500,8831544,8832337,749,8833086
1300,50,50,8839669,8840484,832,8838353,8839151,511,8839662
1301,46,46,8846628,8847377,766,8845179,8845965,656,8846621
1302,42,42,8853604,8854286,699,8851989,8852779,819,8853598
1303,60,60,8860479,8861462,999,8858798,8859593,880,8860473
1304,48,48,8867339,8868121,799,8865624,8866407,926,8867333
1305,4,4,8873732,8873782,66,8872433,8873221,504,8873725
1306,58,58,8880591,8881540,966,8879242,8880035,549,8880584
1307,20,20,8887533,8887850,333,8886052,8886849,678,8887527
1308,16,16,8894426,8894676,266,8892878,8893663,757,8894420
1309,14,14,8901302,8901518,233,8899687,8900477,819,8901296
1310,44,44,8907795,8908511,732,8906496,8907291,497,8907788
1311,18,18,8914637,8914920,300,8913322,8914105,526,8914631
1312,44,44,8921763,8922479,733,8920131,8920919,837,8921756
1313,4,4,8928556,8928606,66,8926941,8927733,817,8928550
1314,36,36,8935165,8935748,600,8933750,8934547,612,8935159
1315,54,54,8942274,8943157,899,8940576,8941361,907,8942268
1316,10,10,8948950,8949100,167,8947385,8948175,769,8948944
1317,56,56,8955526,8956442,933,8954195,8954989,531,8955520
1318,14,14,8962486,8962702,233,8961020,8961803,676,8962479
1319,32,32,8969395,8969911,533,8967830,8968617,772,8969389
1320,22,22,8976254,8976604,366,8974639,8975431,817,8976248
1321,32,32,8982814,8983330,532,8981448,8982245,562,8982807
1322,22,22,8989739,8990089,367,8988274,8989059,674,8989733
1323,28,28,8996565,8997015,466,8995084,8995873,686,8996559
1324,8,8,9003241,9003358,134,9001893,9002687,548,9003235
1325,60,60,9010417,9011399,999,9008702,9009501,910,9010411
1326,14,14,9016960,9017176,233,9015528,9016315,638,9016953
1327,22,22,9024036,9024385,366,9022337,9023129,900,9024029
1328,22,22,9030545,9030895,366,9029147,9029943,596,9030539
1329,30,30,9037521,9038004,499,9035973,9036757,758,9037515
1330,44,44,9044397,9045113,732,9042782,9043571,820,9044391
1331,60,60,9050906,9051889,999,9049591,9050385,515,9050900
1332,36,36,9058132,9058715,599,9056400,9057199,926,9058125
1333,30,30,9064941,9065424,500,9063226,9064013,922,9064935
1334,6,6,9071800,9071884,100,9070036,9070827,968,9071795
1335,28,28,9078543,9078993,466,9076845,9077641,896,9078537
1336,18,18,9085386,9085669,299,9083671,9084455,925,9085380
1337,28,28,9091812,9092262,466,9090480,9091269,536,9091805
1338,38,38,9098688,9099304,633,9097289,9098083,598,9098681
1339,34,34,9105664,9106213,566,9104099,9104897,761,9105658
1340,40,40,9112506,9113156,666,9110925,9111711,789,9112500
1341,46,46,9119415,9120165,766,9117734,9118525,884,9119409
1342,38,38,9126291,9126907,633,9124543,9125339,946,9126285
1343,60,60,9132851,9133833,999,9131369,9132153,691,9132844
1344,30,30,9139727,9140210,499,9138178,9138967,753,9139720
1345,36,36,9146703,9147285,599,9144988,9145781,916,9146697
1346,52,52,9153462,9154311,866,9151797,9152595,861,9153456
1347,10,10,9160404,9160554,167,9158623,9159409,989,9160398
1348,58,58,9167164,9168113,965,9165432,9166223,934,9167157
1349,8,8,9173740,9173856,133,9172242,9173037,697,9173734
1350,60,60,9180466,9181448,999,9179067,9179851,608,9180459
1351,34,34,9187525,9188074,566,9185877,9186665,854,9187519
1352,22,22,9194101,9194451,366,9192686,9193479,616,9194095
1353,26,26,9200960,9201377,433,9199495,9200293,661,9200954
1354,36,36,9207686,9208269,600,9206321,9207107,573,9207680
1355,18,18,9214579,9214862,300,9213131,9213921,652,9214573
1356,38,38,9220739,9221355,633,9219940,9219952,780,9220732
1357,10,10,9227315,9227465,167,9225983,9226766,542,9227308
1358,26,26,9234158,9234574,433,9232793,9233580,572,9234152
1359,20,20,9240984,9241300,333,9239602,9240394,583,9240977
1360,22,22,9248059,9248409,367,9246411,9247208,845,9248053
1361,18,18,9254985,9255268,300,9253237,9254022,957,9254979
1362,30,30,9261412,9261894,499,9260046,9260836,569,9261405
1363,54,54,9268421,9269303,899,9266856,9267650,765,9268415
1364,10,10,9275047,9275197,166,9273682,9274464,577,9275041
1365,52,52,9281873,9282722,865,9280491,9281278,588,9281866
1366,24,24,9288882,9289265,399,9287300,9288092,783,9288875
1367,44,44,9295525,9296240,732,9294109,9294906,612,9295518
1368,56,56,9302334,9303250,932,9300935,9301720,607,9302327
1369,12,12,9309326,9309509,200,9307745,9308534,786,9309320
1370,6,6,9316302,9316385,100,9314554,9315348,948,9316296
1371,10,10,9323028,9323178,167,9321363,9322162,860,9323022
1372,18,18,9329721,9330004,300,9328189,9328976,738,9329714
1373,28,28,9336613,9337063,467,9334998,9335790,817,9336607
1374,50,50,9343439,9344255,833,9341808,9342604,829,9343433
1375,48,48,9350199,9350981,799,9348634,9349418,775,9350193
1376,22,22,9357174,9357524,367,9355443,9356232,936,9357168
1377,52,52,9363801,9364650,865,9362252,9363046,748,9363794
1378,34,34,9370643,9371193,566,9369062,9369860,777,9370637
1379,50,50,9377336,9378152,832,9375887,9376674,655,9377329
1380,28,28,9384162,9384611,466,9382697,9383488,668,9384156
1381,14,14,9390838,9391054,233,9389506,9390302,529,9390831
1382,54,54,9397947,9398829,899,9396332,9397116,825,9397941
1383,12,12,9404490,9404673,200,9403141,9403930,553,9404483
1384,10,10,9411466,9411615,166,9409951,9410744,716,9411460
1385,36,36,9418275,9418858,599,9416760,9417558,711,9418269
1386,6,6,9425217,9425301,100,9423586,9424372,839,9425211
1387,52,52,9431777,9432626,866,9430395,9431186,584,9431770
1388,20,20,9438570,9438886,332,9437204,9438000,563,9438563
1389,30,30,9445479,9445961,499,9444030,9444814,658,9445472
1390,34,34,9452621,9453170,566,9450840,9451628,987,9452615
1391,12,12,9459264,9459447,200,9457649,9458442,816,9459258
1392,48,48,9466173,9466955,799,9464458,9465256,911,9466167
1393,18,18,9472866,9473149,299,9471284,9472070,789,9472859
1394,58,58,9479475,9480424,966,9478093,9478884,584,9479468
1395,2,2,9486434,9486451,34,9484903,9485698,730,9486428
1396,26,26,9493310,9493726,433,9491729,9492512,792,9493304
1397,40,40,9499920,9500569,666,9498538,9499326,587,9499913
1398,46,46,9507012,9507761,766,9505347,9506140,866,9507006
1399,14,14,9513738,9513954,233,9512156,9512954,777,9513731
1400,14,14,9520514,9520730,233,9518982,9519768,739,9520507
1401,42,42,9527090,9527773,699,9525792,9526582,502,9527084
1402,18,18,9534149,9534432,300,9532601,9533396,747,9534143
1403,50,50,9541008,9541824,833,9539427,9540210,792,9541002
1404,20,20,9547768,9548084,333,9546236,9547024,737,9547761
1405,58,58,9554810,9555759,966,9553045,9553838,966,9554804
1406,52,52,9561619,9562469,866,9559855,9560652,962,9561614
1407,16,16,9568429,9568678,266,9566681,9567466,957,9568423
1408,2,2,9574805,9574822,33,9573490,9574280,519,9574799
1409,48,48,9581781,9582563,799,9580299,9581094,680,9581774
1410,54,54,9588823,9589706,899,9587125,9587908,909,9588817
1411,20,20,9595350,9595666,333,9593934,9594722,621,9595343
1412,40,40,9602342,9602991,666,9600744,9601536,800,9602336
1413,50,50,9608885,9609701,832,9607553,9608350,528,9608878
1414,42,42,9616077,9616760,699,9614379,9615164,907,9616071
1415,38,38,9622836,9623452,633,9621188,9621978,852,9622830
1416,52,52,9629429,9630278,866,9627998,9628792,631,9629423
1417,56,56,9636305,9637221,933,9634823,9635606,692,9636298
1418,34,34,9643381,9643930,566,9641633,9642420,955,9643375
1419,58,58,9650040,9650989,966,9648442,9649234,800,9650034
1420,30,30,9656700,9657183,499,9655251,9656048,645,9656693
1421,56,56,9663692,9664608,932,9662077,9662862,824,9663686
1422,14,14,9670202,9670418,233,9668887,9669676,520,9670196
1423,30,30,9677344,9677827,499,9675696,9676490,848,9677338
1424,20,20,9683854,9684170,333,9682505,9683304,543,9683847
1425,14,14,9690763,9690979,233,9689331,9690118,638,9690756
1426,42,42,9697789,9698471,699,9696140,9696932,850,9697782
1427,26,26,9704714,9705131,433,9702950,9703746,963,9704709
1428,6,6,9711357,9711440,100,9709776,9710560,791,9711351
1429,40,40,9718033,9718683,666,9716585,9717374,653,9718027
1430,6,6,9724992,9725076,100,9723394,9724188,798,9724986
1431,58,58,9731802,9732751,965,9730203,9731002,793,9731795
1432,56,56,9738594,9739510,933,9737029,9737816,772,9738588
1433,24,24,9745304,9745687,399,9743839,9744630,668,9745298
1434,52,52,9752163,9753012,866,9750648,9751444,713,9752157
1435,52,52,9758839,9759688,866,9757474,9758258,575,9758833
1436,44,44,9765682,9766397,732,9764283,9765072,603,9765675
1437,20,20,9772707,9773024,333,9771092,9771886,815,9772701
1438,16,16,9779467,9779716,266,9777902,9778700,761,9779461
1439,38,38,9786143,9786759,632,9784728,9785514,623,9786137
1440,20,20,9793135,9793451,333,9791537,9792328,801,9793129
1441,48,48,9799661,9800444,800,9798346,9799142,513,9799655
1442,2,2,9806554,9806571,33,9805172,9805956,591,9806547
1443,12,12,9813480,9813663,200,9811981,9812770,703,9813473
1444,26,26,9820472,9820888,433,9818791,9819584,882,9820466
1445,6,6,9827182,9827265,99,9825600,9826398,777,9827175
1446,58,58,9834057,9835006,966,9832426,9833212,839,9834051
1447,58,58,9840850,9841799,966,9839235,9840026,818,9840844
1448,46,46,9847609,9848359,766,9846044,9846840,763,9847603
1449,10,10,9854469,9854619,166,9852870,9853654,808,9854462
1450,30,30,9861095,9861578,499,9859680,9860468,621,9861089
1451,2,2,9867788,9867804,33,9866489,9867282,499,9867781
1452,52,52,9874647,9875496,866,9873298,9874096,544,9874640
1453,30,30,9881656,9882139,499,9880124,9880910,739,9881649
1454,30,30,9888232,9888715,500,9886933,9887724,501,9888225
1455,14,14,9895274,9895491,234,9893743,9894538,730,9895268
1456,22,22,9901917,9902267,367,9900569,9901352,559,9901911
1457,46,46,9909060,9909809,765,9907378,9908166,887,9909053
1458,54,54,9915652,9916535,899,9914187,9914980,666,9915646
1459,32,32,9922378,9922895,533,9920997,9921794,578,9922372
1460,26,26,9929487,9929904,433,9927822,9928608,873,9929481
1461,26,26,9936363,9936779,433,9934632,9935422,935,9936357
1462,50,50,9943189,9944005,833,9941441,9942236,947,9943183
1463,44,44,9949732,9950448,733,9948267,9949050,676,9949726
1464,52,52,9956541,9957390,866,9955076,9955864,671,9956535
1465,2,2,9963284,9963301,33,9961886,9962678,600,9963278
1466,6,6,9970326,9970410,100,9968695,9969492,828,9970320
1467,18,18,9976919,9977202,300,9975521,9976306,607,9976913
1468,24,24,9983945,9984328,400,9982330,9983120,819,9983939
1469,58,58,9990887,9991836,966,9989139,9989934,947,9990881
1470,14,14,9997347,9997564,233,9995965,9996748,592,9997340
1471,8,8,10004090,10004206,133,10002775,10003562,522,10004084
1472,38,38,10011082,10011698,633,10009584,10010376,700,10011076
1473,30,30,10018008,10018491,500,10016393,10017190,812,10018002
1474,28,28,10024801,10025250,466,10023219,10024004,790,10024794
1475,42,42,10031577,10032259,699,10030028,10030818,752,10031570
1476,44,44,10038619,10039335,733,10036838,10037632,981,10038613
1477,42,42,10045212,10045895,699,10043664,10044446,760,10045206
1478,32,32,10051788,10052304,533,10050473,10051260,522,10051782
1479,56,56,10058781,10059696,932,10057282,10058074,700,10058774
1480,50,50,10065540,10066356,832,10064091,10064888,645,10065533
1481,44,44,10072582,10073298,733,10070917,10071702,874,10072576
1482,52,52,10079425,10080274,866,10077727,10078516,903,10079419
1483,44,44,10085934,10086650,733,10084536,10085330,598,10085928
1484,60,60,10093110,10094092,999,10091345,10092144,960,10093104
1485,34,34,10099620,10100169,566,10098171,10098958,655,10099613
1486,50,50,10106462,10107278,833,10104980,10105772,683,10106455
1487,10,10,10113155,10113305,166,10111790,10112586,563,10113149
1488,38,38,10119931,10120547,633,10118616,10119400,525,10119925
1489,42,42,10127156,10127839,700,10125425,10126214,936,10127150
1490,26,26,10133999,10134415,433,10132234,10133028,965,10133993
1491,10,10,10140692,10140842,166,10139044,10139842,844,10140686
1492,58,58,10147168,10148117,966,10145869,10146656,505,10147161
1493,34,34,10154044,10154593,566,10152679,10153470,568,10154038
1494,58,58,10161153,10162102,966,10159488,10160284,863,10161147
1495,54,54,10167696,10168578,899,10166314,10167098,591,10167689
1496,18,18,10174888,10175171,300,10173123,10173912,970,10174882
1497,44,44,10181431,10182147,732,10179933,10180726,699,10181425
1498,56,56,10188207,10189123,932,10186742,10187540,661,10188201
1499,42,42,10195133,10195815,699,10193568,10194354,773,10195127
1500,44,44,10202142,10202858,732,10200377,10201168,968,10202136
1501,32,32,10208768,10209284,533,10207186,10207982,779,10208761
1502,4,4,10215677,10215727,67,10214012,10214796,875,10215671
1503,54,54,10222337,10223219,899,10220822,10221610,721,10222331
1504,8,8,10229212,10229329,134,10227631,10228424,782,10229206
1505,36,36,10236122,10236704,599,10234440,10235238,877,10236115
1506,16,16,10242781,10243031,266,10241266,10242052,723,10242775
1507,32,32,10249574,10250090,532,10248075,10248866,701,10249567
1508,52,52,10256383,10257232,866,10254885,10255680,697,10256377
1509,44,44,10263475,10264191,733,10261711,10262494,976,10263470
1510,6,6,10270068,10270151,100,10268520,10269308,754,10270062
1511,60,60,10277094,10278076,999,10275329,10276122,966,10277088
1512,40,40,10283670,10284319,666,10282138,10282936,727,10283663
1513,22,22,10290596,10290946,366,10288964,10289750,839,10290589
1514,28,28,10297072,10297522,466,10295774,10296564,502,10297066
1515,48,48,10303915,10304697,799,10302583,10303378,530,10303908
1516,16,16,10311107,10311357,266,10309409,10310192,909,10311101
1517,14,14,10317800,10318016,233,10316218,10317006,787,10317793
1518,20,20,10324459,10324776,333,10323027,10323820,632,10324452
1519,22,22,10331235,10331585,366,10329837,10330634,595,10331229
1520,56,56,10338411,10339326,932,10336663,10337448,957,10338405
1521,4,4,10344771,10344820,66,10343472,10344262,502,10344764
1522,38,38,10351813,10352429,633,10350281,10351076,730,10351806
1523,18,18,10358772,10359055,300,10357107,10357890,876,10358766
1524,12,12,10365282,10365465,199,10363916,10364704,571,10365275
1525,46,46,10372457,10373206,766,10370726,10371518,933,10372451
1526,28,28,10379300,10379749,466,10377535,10378332,962,10379294
1527,26,26,10385676,10386092,433,10384361,10385146,524,10385670
1528,28,28,10392852,10393301,466,10391170,10391960,885,10392845
1529,18,18,10399278,10399561,300,10397980,10398774,498,10399272
1530,58,58,10406154,10407103,966,10404805,10405588,559,10406147
1531,36,36,10413047,10413629,599,10411615,10412402,638,10413040
1532,22,22,10419756,10420106,366,10418424,10419216,533,10419749
1533,12,12,10426632,10426815,200,10425233,10426030,595,10426625
1534,20,20,10433491,10433807,333,10432059,10432844,640,10433484
1535,42,42,10440450,10441133,699,10438869,10439658,786,10440444
1536,60,60,10447243,10448225,999,10445678,10446472,765,10447237
1537,4,4,10454202,10454252,67,10452487,10453286,910,10454196
1538,34,34,10460145,10460695,567,10459313,10459317,821,10460138
1539,2,2,10467021,10467038,34,10465340,10466131,884,10467015
1540,22,22,10473614,10473964,366,10472149,10472945,663,10473608
1541,38,38,10480607,10481223,632,10478975,10479759,841,10480600
1542,8,8,10487299,10487416,134,10485784,10486573,720,10487293
1543,4,4,10494042,10494092,67,10492594,10493387,649,10494036
1544,30,30,10500718,10501201,500,10499403,10500201,511,10500712
1545,16,16,10507627,10507877,267,10506229,10507015,606,10507621
1546,46,46,10514337,10515086,766,10513038,10513829,501,10514330
1547,30,30,10521146,10521629,499,10519847,10520643,496,10521139
1548,32,32,10528272,10528788,532,10526673,10527457,808,10528265
1549,40,40,10535197,10535847,666,10533483,10534271,921,10535192
1550,54,54,10542057,10542939,899,10540292,10541085,966,10542051
1551,26,26,10548666,10549082,433,10547101,10547899,761,10548660
1552,46,46,10555309,10556058,766,10553927,10554713,589,10555302
1553,12,12,10562318,10562501,200,10560736,10561527,784,10562311
1554,14,14,10568977,10569194,234,10567546,10568341,630,10568971
1555,20,20,10575704,10576020,333,10574372,10575155,542,10575697
1556,6,6,10582646,10582729,100,10581181,10581969,671,10582640
1557,44,44,10589555,10590271,733,10587990,10588783,766,10589549
1558,8,8,10596315,10596431,133,10594799,10595597,711,10596308
1559,52,52,10603091,10603940,865,10601625,10602411,673,10603084
1560,50,50,10609916,10610732,833,10608435,10609225,685,10609910
1561,8,8,10616642,10616759,134,10615244,10616039,597,10616636
1562,2,2,10623835,10623851,33,10622070,10622853,976,10623829
1563,50,50,10630511,10631327,832,10628879,10629667,837,10630504
1564,18,18,10637253,10637537,300,10635689,10636481,767,10637248
1565,44,44,10644063,10644779,732,10642498,10643295,762,10644057
1566,32,32,10651005,10651521,533,10649324,10650109,890,10650999
1567,8,8,10657448,10657565,133,10656133,10656923,519,10657442
1568,2,2,10664507,10664524,34,10662942,10663737,764,10664501
1569,60,60,10671200,10672182,999,10669768,10670551,642,10671193
1570,24,24,10678342,10678725,400,10676578,10677365,972,10678337
1571,6,6,10684835,10684918,100,10683387,10684179,650,10684829
1572,20,20,10691511,10691828,333,10690196,10690993,512,10691505
1573,28,28,10698587,10699037,466,10697022,10697807,774,10698581
1574,18,18,10705579,10705862,300,10703831,10704621,952,10705573
1575,28,28,10712039,10712489,466,10710641,10711435,598,10712033
1576,26,26,10718982,10719398,432,10717467,10718249,727,10718976
1577,8,8,10725807,10725924,134,10724276,10725063,738,10725801
1578,56,56,10732866,10733782,933,10731085,10731877,983,10732860
1579,40,40,10739243,10739892,666,10737894,10738691,545,10739236
1580,6,6,10746052,10746135,100,10744720,10745505,540,10746045
1581,52,52,10753078,10753927,866,10751530,10752319,753,10753072
1582,58,58,10759821,10760770,965,10758339,10759133,681,10759814
1583,52,52,10766813,10767662,866,10765148,10765947,860,10766807
1584,4,4,10773606,10773656,66,10771974,10772761,838,10773599
1585,56,56,10780398,10781314,933,10778783,10779575,817,10780392
1586,18,18,10786958,10787241,300,10785593,10786389,563,10786952
1587,60,60,10793751,10794733,998,10792419,10793203,541,10793744
1588,4,4,10800743,10800793,67,10799228,10800017,720,10800737
1589,16,16,10807819,10808068,266,10806037,10806831,981,10807812
1590,60,60,10814378,10815360,999,10812846,10813645,726,10814371
1591,42,42,10821337,10822020,700,10819672,10820459,872,10821331
1592,14,14,10827780,10827997,233,10826482,10827273,501,10827774
1593,32,32,10834590,10835106,532,10833291,10834087,496,10834583
1594,24,24,10841832,10842215,399,10840117,10840901,925,10841826
1595,36,36,10848641,10849224,599,10846926,10847715,920,10848635
1596,48,48,10855067,10855850,800,10853735,10854529,531,10855060
1597,40,40,10862010,10862659,666,10860545,10861343,661,10862004
1598,36,36,10868753,10869335,599,10867371,10868157,589,10868746
1599,44,44,10875578,10876294,733,10874180,10874971,601,10875572
1600,2,2,10882288,10882305,33,10880989,10881785,496,10882281
1601,38,38,10889380,10889996,633,10887815,10888599,775,10889374
1602,16,16,10896406,10896656,266,10894624,10895413,986,10896399
1603,50,50,10902916,10903731,832,10901434,10902227,682,10902909
1604,56,56,10909575,10910491,932,10908243,10909041,527,10909568
1605,58,58,10916800,10917749,966,10915069,10915855,939,10916794
1606,38,38,10923543,10924159,633,10921878,10922669,868,10923537
1607,4,4,10930069,10930119,67,10928688,10929483,580,10930063
1608,38,38,10936912,10937528,633,10935513,10936297,608,10936905
1609,50,50,10943771,10944587,833,10942323,10943111,654,10943765
1610,14,14,10950897,10951113,233,10949132,10949925,966,10950891
1611,46,46,10957556,10958305,766,10955941,10956739,811,10957550
1612,42,42,10964349,10965031,699,10962767,10963553,789,10964342
1613,50,50,10971075,10971891,832,10969577,10970367,702,10971069
1614,30,30,10977884,10978367,500,10976386,10977181,697,10977878
1615,32,32,10984910,10985426,533,10983212,10983995,909,10984904
1616,38,38,10991753,10992369,632,10990021,10990809,937,10991746
1617,46,46,10998545,10999294,766,10996830,10997623,916,10998539
1618,36,36,11005305,11005887,599,11003640,11004437,862,11005299
1619,2,2,11011748,11011764,33,11010466,11011251,490,11011741
1620,14,14,11018773,11018990,233,11017275,11018065,702,11018767
1621,14,14,11025816,11026032,233,11024084,11024879,930,11025809
1622,48,48,11032392,11033174,799,11030910,11031693,692,11032385
1623,4,4,11039101,11039151,67,11037719,11038507,587,11039094
1624,20,20,11045861,11046177,333,11044529,11045321,533,11045854
1625,48,48,11053119,11053902,799,11051338,11052135,978,11053113
1626,36,36,11059696,11060278,599,11058164,11058949,740,11059689
1627,60,60,11066521,11067504,999,11064973,11065763,752,11066515
1628,4,4,11073497,11073547,67,11071782,11072577,914,11073491
1629,24,24,11079990,11080373,400,11078608,11079391,592,11079983
1630,38,38,11086733,11087349,633,11085418,11086205,522,11086727
1631,34,34,11093925,11094475,566,11092227,11093019,900,11093919
1632,12,12,11100684,11100868,200,11099036,11099833,845,11100678
1633,6,6,11107527,11107610,100,11105862,11106647,874,11107521
1634,50,50,11114420,11115235,832,11112671,11113461,952,11114413
1635,28,28,11121096,11121545,466,11119481,11120275,815,11121090
1636,12,12,11127755,11127938,200,11126290,11127089,660,11127749
1637,20,20,11134781,11135097,333,11133116,11133903,872,11134775
1638,58,58,11141474,11142423,965,11139925,11140717,750,11141467
1639,40,40,11148383,11149032,666,11146735,11147531,846,11148377
1640,12,12,11155209,11155392,199,11153560,11154345,857,11155202
1641,16,16,11161652,11161901,266,11160370,11161159,486,11161645
1642,52,52,11168561,11169410,866,11167179,11167973,581,11168554
1643,34,34,11175304,11175853,566,11173988,11174787,510,11175297
1644,4,4,11182429,11182479,67,11180814,11181601,822,11182423
1645,22,22,11189139,11189488,366,11187624,11188415,718,11189133
1646,10,10,11195948,11196098,166,11194433,11195229,713,11195942
1647,12,12,11202857,11203040,200,11201259,11202043,808,11202851
1648,4,4,11209500,11209550,66,11208068,11208857,636,11209493
1649,14,14,11216193,11216409,233,11214877,11215671,515,11216186
1650,12,12,11223385,11223568,200,11221687,11222485,894,11223379
1651,10,10,11229978,11230127,166,11228513,11229299,673,11229972
1652,6,6,11236920,11237003,100,11235322,11236113,801,11236914
1653,2,2,11243563,11243580,33,11242131,11242927,629,11243556
1654,46,46,11250689,11251438,765,11248957,11249741,941,11250682
1655,24,24,11257065,11257448,400,11255766,11256555,503,11257058
1656,12,12,11264024,11264207,200,11262576,11263369,649,11264018
1657,6,6,11271116,11271200,100,11269385,11270183,927,11271110
1658,42,42,11277792,11278475,700,11276211,11276997,789,11277786
1659,50,50,11284419,11285234,832,11283020,11283811,601,11284412
1660,8,8,11291544,11291661,133,11289829,11290625,913,11291538
1661,42,42,11298320,11299003,699,11296655,11297439,875,11298314
1662,14,14,11304780,11304996,233,11303465,11304253,521,11304774
1663,28,28,11311656,11312105,466,11310274,11311067,582,11311649
1664,38,38,11318632,11319248,632,11317083,11317881,744,11318625
1665,48,48,11325408,11326190,799,11323909,11324695,706,11325401
1666,38,38,11332400,11333016,633,11330718,11331509,884,11332393
1667,22,22,11339026,11339376,366,11337528,11338323,697,11339020
1668,6,6,11345919,11346002,100,11344354,11345137,776,11345913
1669,24,24,11352595,11352978,399,11351163,11351951,637,11352588
1670,58,58,11359570,11360519,966,11357972,11358765,799,11359564
1671,6,6,11366563,11366646,100,11364782,11365579,978,11366557
1672,2,2,11373306,11373322,33,11371607,11372393,906,11373299
1673,36,36,11379799,11380381,599,11378417,11379207,585,11379792
1674,48,48,11386558,11387340,799,11385226,11386021,530,11386551
1675,10,10,11393584,11393733,166,11392052,11392835,742,11393577
1676,12,12,11400293,11400476,200,11398861,11399649,637,11400286
1677,18,18,11407435,11407718,300,11405671,11406463,967,11407430
1678,36,36,11414028,11414611,599,11412480,11413277,745,11414022
1679,8,8,11420937,11421054,134,11419306,11420091,840,11420931
1680,12,12,11427447,11427630,200,11426115,11426905,535,11427440
1681,58,58,11434639,11435588,966,11432924,11433719,914,11434633
1682,30,30,11441448,11441931,500,11439750,11440533,909,11441442
1683,58,58,11448241,11449190,966,11446560,11447347,888,11448235
1684,56,56,11454950,11455866,933,11453369,11454161,783,11454944
1685,60,60,11461943,11462925,999,11460178,11460975,962,11461937
1686,56,56,11468336,11469252,932,11467004,11467789,540,11468329
1687,26,26,11475478,11475894,433,11473813,11474603,869,11475472
1688,52,52,11482221,11483070,866,11480623,11481417,798,11482215
1689,18,18,11489130,11489413,300,11487449,11488231,893,11489124
1690,28,28,11495906,11496356,466,11494258,11495045,855,11495900
1691,52,52,11502516,11503365,865,11501067,11501859,650,11502509
1692,50,50,11509558,11510374,832,11507876,11508673,878,11509551
1693,18,18,11516234,11516517,300,11514702,11515487,740,11516227
1694,20,20,11523027,11523343,333,11521512,11522301,720,11523021
1695,16,16,11529886,11530136,266,11528321,11529115,765,11529880
1696,54,54,11536579,11537461,899,11535130,11535929,643,11536572
1697,10,10,11543521,11543671,167,11541956,11542743,772,11543515
1698,16,16,11550181,11550430,266,11548765,11549557,617,11550174
1699,58,58,11557006,11557955,966,11555575,11556371,629,11557000
1700,6,6,11563966,11564049,100,11562401,11563185,775,11563960
1701,30,30,11570858,11571341,500,11569210,11569999,853,11570852
1702,28,28,11577601,11578050,466,11576019,11576813,781,11577594
1703,12,12,11584577,11584760,199,11582828,11583627,943,11584570
1704,20,20,11591136,11591452,333,11589654,11590441,688,11591129
1705,60,60,11598228,11599211,999,11596464,11597255,968,11598223
1706,32,32,11604771,11605287,533,11603273,11604069,696,11604765
1707,10,10,11611647,11611797,167,11610099,11610883,758,11611641
1708,28,28,11618240,11618690,466,11616908,11617697,536,11618233
1709,54,54,11625066,11625948,899,11623717,11624511,548,11625059
1710,30,30,11631859,11632341,499,11630527,11631325,527,11631852
1711,52,52,11639084,11639933,866,11637353,11638139,939,11639078
1712,10,10,11645577,11645727,167,11644162,11644953,618,11645571
1713,30,30,11652270,11652753,499,11650971,11651767,496,11652263
1714,46,46,11659129,11659878,766,11657797,11658581,541,11659122
1715,22,22,11666171,11666521,367,11664607,11665395,771,11666166
1716,28,28,11672931,11673380,466,11671416,11672209,716,11672925
1717,26,26,11680006,11680423,433,11678225,11679023,977,11680000
1718,34,34,11686533,11687082,566,11685051,11685837,689,11686526
1719,24,24,11693459,11693841,399,11691860,11692651,801,11693452
1720,16,16,11699968,11700218,267,11698670,11699465,497,11699962
1721,52,52,11707244,11708093,865,11705496,11706279,959,11707238
1722,6,6,11713620,11713703,100,11712305,11713093,521,11713614
1723,6,6,11720862,11720945,100,11719114,11719907,949,11720856
1724,44,44,11727405,11728121,733,11725923,11726721,677,11727398
1725,48,48,11734198,11734980,799,11732749,11733535,656,11734191
1726,52,52,11741140,11741989,866,11739559,11740349,785,11741134
1727,8,8,11747949,11748066,134,11746368,11747163,780,11747943
1728,60,60,11754775,11755758,999,11753194,11753977,792,11754769
1729,34,34,11761568,11762117,566,11760003,11760791,771,11761562
1730,2,2,11768228,11768244,33,11766812,11767605,616,11768221
1731,16,16,11775253,11775503,267,11773622,11774419,828,11775247
1732,34,34,11782162,11782712,566,11780448,11781233,924,11782157
1733,16,16,11788955,11789205,266,11787257,11788047,902,11788949
1734,46,46,11795831,11796580,766,11794066,11794861,964,11795825
1735,54,54,11802557,11803439,899,11800892,11801675,876,11802551
1736,58,58,11809233,11810182,966,11807701,11808489,737,11809226
1737,38,38,11816009,11816625,633,11814511,11815303,700,11816003
1738,42,42,11822635,11823318,699,11821320,11822117,512,11822629
1739,30,30,11829528,11830011,499,11828146,11828931,590,11829521
1740,60,60,11836537,11837519,999,11834955,11835745,785,11836530
1741,52,52,11843429,11844278,866,11841764,11842559,864,11843423
1742,4,4,11850239,11850289,66,11848590,11849373,859,11850232
1743,4,4,11856848,11856898,67,11855400,11856187,655,11856842
1744,56,56,11863841,11864756,932,11862209,11863001,833,11863834
1745,32,32,11870550,11871066,533,11869018,11869815,728,11870543
1746,10,10,11877459,11877609,167,11875844,11876629,824,11877453
1747,50,50,11884402,11885217,832,11882653,11883443,952,11884395
1748,12,12,11890761,11890944,200,11889463,11890257,498,11890755
1749,24,24,11897587,11897970,400,11896272,11897071,510,11897581
1750,38,38,11904663,11905279,633,11903098,11903885,772,11904657
1751,40,40,11911589,11912238,666,11909907,11910699,883,11911582
1752,10,10,11918331,11918481,167,11916717,11917513,813,11918326
1753,4,4,11925274,11925324,67,11923542,11924327,940,11925267
1754,40,40,11931834,11932483,665,11930352,11931141,686,11931827
1755,50,50,11938776,11939592,832,11937161,11937955,815,11938770
1756,54,54,11945652,11946534,899,11943970,11944769,876,11945645
1757,24,24,11951412,11951795,400,11950796,11950800,605,11951405
1758,36,36,11958288,11958871,600,11956823,11957614,668,11958282
1759,16,16,11965114,11965364,266,11963632,11964428,679,11965107
1760,8,8,11971890,11972007,133,11970458,11971242,641,11971883
1761,56,56,11978716,11979632,932,11977268,11978056,654,11978710
1762,58,58,11985692,11986641,965,11984077,11984870,816,11985686
1763,14,14,11992251,11992468,233,11990886,11991684,561,11992245
1764,50,50,11999493,12000309,833,11997712,11998498,989,11999487
1765,36,36,12006053,12006636,599,12004521,12005312,734,12006046
1766,36,36,12013079,12013661,599,12011331,12012126,947,12013073
1767,40,40,12019488,12020138,666,12018157,12018940,542,12019482
1768,14,14,12026448,12026664,233,12024966,12025754,687,12026441
1769,6,6,12033540,12033623,100,12031775,12032568,966,12033534
1770,14,14,12040333,12040549,233,12038584,12039382,944,12040326
1771,6,6,12046992,12047075,100,12045410,12046196,789,12046985
1772,10,10,12053901,12054051,167,12052220,12053010,885,12053895
1773,54,54,12060627,12061510,899,12059029,12059824,797,12060621
1774,2,2,12067586,12067603,34,12065855,12066638,942,12067580
1775,52,52,12074113,12074962,865,12072664,12073452,654,12074106
1776,50,50,12080772,12081588,832,12079473,12080266,499,12080765
1777,22,22,12087981,12088331,366,12086283,12087080,895,12087975
1778,18,18,12094790,12095073,300,12093109,12093894,890,12094784
1779,46,46,12101583,12102332,766,12099918,12100708,869,12101577
1780,46,46,12108442,12109191,766,12106727,12107522,914,12108436
1781,56,56,12114968,12115884,933,12113553,12114336,626,12114962
1782,2,2,12122061,12122077,33,12120362,12121150,904,12122054
1783,36,36,12128853,12129436,600,12127172,12127964,883,12128847
1784,30,30,12135646,12136129,499,12133981,12134778,862,12135640
1785,32,32,12142472,12142988,533,12140807,12141592,874,12142466
1786,18,18,12148998,12149281,300,12147616,12148406,585,12148991
1787,6,6,12156157,12156240,100,12154426,12155220,931,12156151
1788,4,4,12162717,12162767,66,12161251,12162034,676,12162710
1789,20,20,12169626,12169942,333,12168061,12168848,772,12169620
1790,60,60,12176602,12177584,998,12174870,12175662,933,12176595
1791,18,18,12183427,12183710,300,12181679,12182476,945,12183421
1792,24,24,12190070,12190453,400,12188505,12189290,774,12190064
1793,4,4,12196996,12197046,67,12195315,12196104,886,12196990
1794,16,16,12203589,12203839,266,12202124,12202918,665,12203583
1795,54,54,12210548,12211430,899,12208933,12209732,810,12210542
1796,30,30,12217407,12217890,500,12215759,12216546,855,12217401
1797,44,44,12223917,12224633,732,12222568,12223360,550,12223910
1798,26,26,12231159,12231575,433,12229378,12230174,979,12231153
1799,54,54,12237602,12238484,899,12236204,12236988,608,12237596
1800,36,36,12244345,12244927,599,12243013,12243802,536,12244338
1801,12,12,12251154,12251337,200,12249822,12250616,531,12251147
1802,56,56,12258163,12259079,932,12256631,12257430,726,12258156
1803,48,48,12264823,12265605,799,12263457,12264244,572,12264816
1804,14,14,12271965,12272181,233,12270267,12271058,901,12271959
1805,16,16,12278691,12278941,266,12277076,12277872,813,12278685
1806,30,30,12285367,12285850,499,12283902,12284686,675,12285361
1807,18,18,12292393,12292676,299,12290711,12291500,886,12292386
1808,54,54,12298886,12299768,899,12297520,12298314,565,12298879
1809,8,8,12306045,12306161,133,12304330,12305128,911,12306039
1810,36,36,12312737,12313320,600,12311156,12311942,789,12312731
1811,56,56,12319513,12320429,933,12317965,12318756,751,12319507
1812,54,54,12326273,12327155,899,12324774,12325570,696,12326266
1813,12,12,12333148,12333332,200,12331600,12332384,758,12333142
1814,38,38,12340008,12340624,632,12338409,12339198,803,12340001
1815,56,56,12346950,12347866,933,12345219,12346012,932,12346944
1816,6,6,12353743,12353826,100,12352028,12352826,911,12353737
1817,22,22,12360552,12360902,366,12358854,12359640,906,12360546
1818,16,16,12366962,12367212,266,12365663,12366454,501,12366955
1819,50,50,12374054,12374870,833,12372473,12373268,780,12374048
1820,8,8,12379798,12379914,133,12379298,12379299,491,12379790
1821,26,26,12386890,12387306,433,12385325,12386113,771,12386884
1822,18,18,12393566,12393849,300,12392135,12392927,633,12393560
1823,34,34,12400642,12401191,566,12398944,12399741,895,12400636
1824,8,8,12407535,12407651,133,12405770,12406555,974,12407529
1825,16,16,12414027,12414277,267,12412579,12413369,652,12414021
1826,22,22,12421053,12421403,366,12419388,12420183,864,12421047
1827,48,48,12427796,12428578,799,12426214,12426997,792,12427789
1828,42,42,12434688,12435371,700,12433024,12433811,872,12434683
1829,32,32,12441231,12441747,533,12439833,12440625,600,12441225
1830,40,40,12447957,12448607,666,12446642,12447439,512,12447951
1831,24,24,12454916,12455299,400,12453468,12454253,657,12454910
1832,36,36,12461926,12462508,599,12460277,12461067,852,12461919
1833,16,16,12468435,12468685,267,12467087,12467881,548,12468429
1834,46,46,12475544,12476293,766,12473913,12474695,843,12475538
1835,6,6,12482120,12482204,100,12480722,12481509,605,12482114
1836,2,2,12489246,12489263,33,12487531,12488323,917,12489240
1837,28,28,12495706,12496155,466,12494340,12495137,562,12495699
1838,22,22,12502765,12503114,366,12501166,12501951,807,12502758
1839,22,22,12509541,12509890,366,12507976,12508765,770,12509535
1840,6,6,12516350,12516433,100,12514785,12515579,765,12516344
1841,46,46,12523209,12523958,766,12521594,12522393,810,12523203
1842,2,2,12530202,12530218,33,12528420,12529207,988,12530195
1843,2,2,12536695,12536711,33,12535229,12536021,667,12536688
1844,30,30,12543454,12543937,499,12542039,12542835,613,12543448
1845,56,56,12550197,12551112,932,12548865,12549649,541,12550190
1846,6,6,12557156,12557239,100,12555674,12556463,686,12557149
1847,2,2,12563915,12563932,33,12562483,12563277,631,12563908
1848,22,22,12570924,12571274,366,12569293,12570091,827,12570918
1849,28,28,12577517,12577966,466,12576118,12576905,605,12577510
1850,50,50,12584543,12585358,832,12582928,12583719,818,12584537
1851,24,24,12591102,12591485,400,12589737,12590533,563,12591096
1852,60,60,12597895,12598877,999,12596563,12597347,541,12597888
1853,2,2,12604904,12604921,33,12603372,12604161,736,12604897
1854,40,40,12611763,12612412,666,12610182,12610975,782,12611757
1855,50,50,12618473,12619288,832,12616991,12617789,677,12618466
1856,50,50,12625415,12626231,832,12623817,12624603,806,12625409
1857,14,14,12631941,12632158,233,12630626,12631417,518,12631935
1858,20,20,12638867,12639183,333,12637435,12638231,629,12638860
1859,34,34,12645943,12646492,566,12644261,12645045,891,12645936
1860,52,52,12652785,12653634,866,12651071,12651859,921,12652780
1861,28,28,12659378,12659828,466,12657880,12658673,699,12659372
1862,2,2,12666470,12666487,34,12664689,12665487,977,12666464
1863,26,26,12673063,12673480,433,12671515,12672301,756,12673057
1864,56,56,12679706,12680622,932,12678324,12679115,584,12679699
1865,20,20,12686765,12687081,333,12685134,12685929,830,12686759
1866,38,38,12693375,12693991,632,12691960,12692743,626,12693369
1867,20,20,12700334,12700650,333,12698769,12699557,771,12700328
1868,20,20,12706893,12707210,333,12705578,12706371,516,12706887
1869,30,30,12714019,12714502,499,12712387,12713185,827,12714012
1870,30,30,12720512,12720995,499,12719213,12719999,506,12720505
1871,18,18,12727771,12728054,299,12726023,12726813,952,12727765
1872,10,10,12734430,12734580,167,12732832,12733627,797,12734424
1873,4,4,12741373,12741423,66,12739658,12740441,926,12741367
1874,36,36,12748149,12748731,599,12746467,12747255,887,12748142
1875,50,50,12754808,12755624,833,12753276,12754069,732,12754801
1876,4,4,12761468,12761517,66,12760086,12760883,578,12761461
1877,40,40,12768327,12768976,666,12766912,12767697,624,12768321
1878,38,38,12775486,12776102,632,12773721,12774511,969,12775480
1879,6,6,12782195,12782278,100,12780530,12781325,864,12782189
1880,36,36,12789121,12789704,599,12787356,12788139,976,12789115
1881,60,60,12795897,12796879,999,12794165,12794953,937,12795890
1882,36,36,12802473,12803056,599,12800975,12801767,700,12802467
1883,38,38,12809432,12810048,633,12807784,12808581,845,12809426
1884,20,20,12815942,12816258,333,12814610,12815395,540,12815935
1885,20,20,12823034,12823350,333,12821419,12822209,819,12823028
1886,16,16,12829927,12830176,266,12828228,12829023,897,12829920
1887,28,28,12836536,12836986,466,12835054,12835837,692,12836529
1888,10,10,12843495,12843645,167,12841864,12842651,838,12843489
1889,52,52,12850305,12851154,865,12848673,12849465,833,12850298
1890,40,40,12857180,12857830,666,12855482,12856279,895,12857174
1891,24,24,12864056,12864439,400,12862308,12863093,957,12864050
1892,20,20,12870483,12870799,333,12869117,12869907,569,12870476
1893,38,38,12876626,12877242,633,12875927,12875938,681,12876619
1894,60,60,12883752,12884734,999,12881954,12882752,994,12883746
1895,58,58,12890061,12891010,966,12888780,12889566,489,12890055
1896,46,46,12896954,12897703,766,12895589,12896380,568,12896948
1897,8,8,12903747,12903863,133,12902398,12903194,546,12903740
1898,28,28,12910689,12911139,466,12909224,12910008,675,12910683
1899,42,42,12917498,12918181,700,12916033,12916822,670,12917492
1900,54,54,12924408,12925290,899,12922843,12923636,766,12924402
1901,32,32,12930967,12931483,533,12929652,12930450,511,12930961
1902,54,54,12938009,12938892,900,12936478,12937264,739,12938003
1903,48,48,12944619,12945401,799,12943287,12944078,534,12944612
1904,54,54,12951795,12952677,899,12950096,12950892,896,12951788
1905,24,24,12958271,12958654,399,12956922,12957706,558,12958264
1906,30,30,12965080,12965563,500,12963732,12964520,554,12965074
1907,32,32,12972272,12972788,533,12970541,12971334,932,12972266
1908,10,10,12978749,12978898,166,12977350,12978148,594,12978742
1909,4,4,12985674,12985724,67,12984176,12984962,706,12985668
1910,48,48,12992567,12993349,799,12990985,12991776,784,12992560
1911,52,52,12999110,12999959,866,12997795,12998590,514,12999104
1912,56,56,13005953,13006868,932,13004621,13005404,542,13005946
1913,54,54,13012895,13013777,899,13011430,13012218,671,13012889
1914,22,22,13019904,13020254,366,13018239,13019032,866,13019898
1915,26,26,13026447,13026863,433,13025048,13025846,594,13026440
1916,6,6,13033506,13033589,100,13031874,13032660,839,13033499
1917,14,14,13040299,13040515,233,13038684,13039474,819,13040293
1918,42,42,13047075,13047757,699,13045493,13046288,780,13047068
1919,50,50,13053618,13054433,832,13052319,13053102,509,13053611
1920,20,20,13060460,13060776,333,13059128,13059916,537,13060453
1921,50,50,13067569,13068385,832,13065937,13066730,832,13067562
1922,32,32,13074512,13075028,532,13072747,13073544,962,13074506
1923,6,6,13080955,13081038,99,13079573,13080358,590,13080948
1924,42,42,13087847,13088530,699,13086382,13087172,669,13087841
1925,50,50,13094573,13095389,833,13093191,13093986,580,13094566
1926,36,36,13101799,13102381,599,13100017,13100800,992,13101792
1927,6,6,13108192,13108275,100,13106826,13107614,571,13108185
1928,50,50,13115184,13116000,833,13113636,13114428,750,13115178
1929,60,60,13121927,13122909,999,13120445,13121242,678,13121920
1930,26,26,13127987,13128403,433,13127271,13127273,707,13127980
1931,2,2,13134696,13134713,34,13133298,13134087,603,13134690
1932,16,16,13141589,13141839,266,13140107,13140901,681,13141582
1933,26,26,13148531,13148947,433,13146916,13147715,810,13148525
1934,42,42,13155291,13155973,699,13153742,13154529,755,13155284
1935,36,36,13162150,13162733,599,13160552,13161343,801,13162144
1936,2,2,13169042,13169059,34,13167361,13168157,879,13169036
1937,14,14,13175968,13176185,233,13174187,13174971,991,13175962
1938,4,4,13182761,13182811,66,13180996,13181785,970,13182755
1939,22,22,13189337,13189687,366,13187805,13188599,731,13189330
1940,38,38,13195963,13196579,633,13194615,13195413,544,13195957
1941,16,16,13203155,13203405,267,13201441,13202227,923,13203150
1942,28,28,13209865,13210314,466,13208250,13209041,818,13209859
1943,46,46,13216791,13217540,765,13215059,13215855,929,13216784
1944,24,24,13223500,13223883,400,13221885,13222669,825,13223494
1945,40,40,13230193,13230842,666,13228694,13229483,703,13230186
1946,44,44,13237035,13237751,733,13235504,13236297,732,13237029
1947,50,50,13243895,13244710,832,13242313,13243111,777,13243888
1948,56,56,13250487,13251403,933,13249139,13249925,556,13250481
1949,32,32,13257646,13258162,533,13255948,13256739,901,13257640
1950,24,24,13264089,13264472,400,13262757,13263553,529,13264082
1951,48,48,13271215,13271997,799,13269583,13270367,841,13271208
1952,30,30,13277741,13278224,500,13276393,13277181,554,13277735
1953,10,10,13284900,13285050,167,13283202,13283995,899,13284894
1954,6,6,13291643,13291726,100,13290011,13290809,827,13291636
1955,34,34,13298602,13299151,566,13296837,13297623,973,13298596
1956,42,42,13305378,13306061,699,13303646,13304437,934,13305371
1957,28,28,13312121,13312570,466,13310456,13311251,864,13312115
1958,58,58,13319030,13319979,965,13317282,13318065,959,13319024
1959,42,42,13325573,13326255,699,13324091,13324879,687,13325566
1960,16,16,13332265,13332515,267,13330900,13331693,566,13332259
1961,34,34,13339491,13340040,566,13337710,13338507,978,13339485
1962,46,46,13346034,13346783,766,13344535,13345321,706,13346027
1963,6,6,13352643,13352727,100,13351345,13352135,502,13352637
1964,42,42,13359836,13360518,699,13358154,13358949,880,13359829
1965,4,4,13366612,13366661,66,13364980,13365763,842,13366605
1966,8,8,13373338,13373454,133,13371789,13372577,754,13373331
1967,4,4,13380130,13380180,67,13378599,13379391,733,13380124
1968,10,10,13387056,13387206,167,13385408,13386205,845,13387050
1969,30,30,13393566,13394048,499,13392234,13393019,540,13393559
1970,20,20,13400791,13401107,333,13399043,13399833,952,13400785
1971,56,56,13407551,13408466,932,13405852,13406647,897,13407544
1972,34,34,13413977,13414526,566,13412678,13413461,509,13413970
1973,42,42,13420886,13421569,699,13419488,13420275,605,13420880
1974,44,44,13427845,13428561,733,13426297,13427089,750,13427839
1975,22,22,13434488,13434838,366,13433106,13433903,578,13434481
1976,16,16,13441580,13441830,267,13439932,13440717,857,13441574
1977,6,6,13448290,13448373,100,13446741,13447531,752,13448283
1978,34,34,13455066,13455615,566,13453551,13454345,715,13455060
1979,48,48,13461858,13462641,799,13460377,13461159,693,13461852
1980,20,20,13468518,13468834,333,13467186,13467973,538,13468511
1981,54,54,13475743,13476626,899,13473995,13474787,950,13475737
1982,52,52,13482486,13483335,866,13480804,13481601,878,13482479
1983,10,10,13489079,13489229,166,13487630,13488415,657,13489072
1984,60,60,13495039,13496021,999,13494440,13494446,586,13495032
1985,48,48,13501898,13502681,799,13500466,13501260,631,13501891
1986,38,38,13508641,13509257,633,13507276,13508074,561,13508635
1987,6,6,13515767,13515850,99,13514102,13514888,873,13515761
1988,44,44,13522359,13523075,733,13520911,13521702,651,13522353
1989,52,52,13529402,13530251,866,13527720,13528516,879,13529395
1990,42,42,13536161,13536844,699,13534546,13535330,825,13536155
1991,26,26,13542954,13543370,433,13541355,13542144,803,13542947
1992,58,58,13549896,13550845,966,13548165,13548958,932,13549890
1993,12,12,13556739,13556922,200,13554974,13555772,961,13556733
1994,30,30,13563182,13563665,499,13561800,13562586,589,13563175
1995,20,20,13570241,13570557,333,13568609,13569400,834,13570234
1996,22,22,13577033,13577383,367,13575419,13576214,814,13577028
1997,28,28,13583859,13584309,467,13582244,13583028,825,13583853
1998,40,40,13590502,13591151,666,13589054,13589842,654,13590496
1999,6,6,13597428,13597511,100,13595863,13596656,766,13597422
2000,8,8,13604321,13604437,133,13602672,13603470,844,13604314
2001,8,8,13611130,13611246,133,13609498,13610284,839,13611123
2002,58,58,13617889,13618838,966,13616308,13617098,785,13617883
2003,10,10,13624782,13624932,166,13623117,13623912,864,13624776
2004,38,38,13631441,13632057,633,13629943,13630726,709,13631435
2005,42,42,13638284,13638966,699,13636752,13637540,737,13638277
2006,26,26,13645126,13645543,433,13643561,13644354,766,13645120
2007,10,10,13651719,13651869,167,13650371,13651168,545,13651713
2008,48,48,13658945,13659727,799,13657197,13657982,957,13658939
2009,56,56,13665338,13666253,932,13664006,13664796,535,13665331
2010,18,18,13672247,13672530,300,13670815,13671610,630,13672240
2011,18,18,13678973,13679256,300,13677641,13678424,542,13678966
2012,24,24,13686049,13686432,399,13684450,13685238,804,13686042
2013,12,12,13692675,13692858,200,13691260,13692052,617,13692669
2014,38,38,13699617,13700233,633,13698069,13698866,745,13699611
2015,26,26,13706643,13707059,433,13704895,13705680,957,13706637
2016,36,36,13713003,13713585,599,13711704,13712494,502,13712996
2017,24,24,13719979,13720361,399,13718513,13719308,664,13719972
2018,18,18,13726821,13727104,300,13725339,13726122,692,13726814
2019,20,20,13733830,13734146,333,13732149,13732936,888,13733824
2020,24,24,13740306,13740689,400,13738958,13739750,550,13740300
2021,10,10,13747232,13747382,167,13745767,13746564,662,13747226
2022,56,56,13753892,13754807,932,13752593,13753378,507,13753885
2023,28,28,13760734,13761184,467,13759402,13760192,535,13760727
2024,10,10,13767860,13768010,166,13766212,13767006,848,13767854
2025,22,22,13774503,13774852,366,13773021,13773820,676,13774496
2026,38,38,13781595,13782211,633,13779847,13780634,955,13781589
2027,6,6,13788371,13788454,100,13786656,13787448,917,13788365
2028,10,10,13795064,13795214,166,13793466,13794262,796,13795058
2029,42,42,13801590,13802273,699,13800291,13801076,507,13801583
2030,4,4,13808582,13808632,67,13807101,13807890,686,13808576
2031,14,14,13815558,13815775,233,13813910,13814704,848,13815552
2032,36,36,13822035,13822617,599,13820719,13821518,510,13822028
2033,10,10,13829027,13829177,166,13827545,13828332,688,13829020
2034,2,2,13835770,13835786,33,13834355,13835146,618,13835764
2035,4,4,13842812,13842862,67,13841164,13841960,846,13842806
2036,24,24,13849621,13850004,400,13847990,13848774,841,13849615
2037,36,36,13856514,13857097,599,13854799,13855588,920,13856508
2038,4,4,13863373,13863423,67,13861608,13862402,965,13863367
2039,44,44,13869749,13870465,733,13868418,13869216,527,13869743
2040,50,50,13876908,13877724,833,13875244,13876030,873,13876903
2041,14,14,13883751,13883967,233,13882053,13882844,901,13883745
2042,4,4,13890244,13890294,67,13888862,13889658,579,13890237
2043,34,34,13897286,13897836,566,13895688,13896472,808,13897280
2044,26,26,13903779,13904195,433,13902497,13903286,486,13903772
2045,24,24,13910922,13911304,399,13909307,13910100,816,13910916
2046,38,38,13917514,13918130,633,13916116,13916914,594,13917508
2047,14,14,13924440,13924657,233,13922942,13923728,706,13924434
2048,56,56,13931100,13932015,932,13929751,13930542,551,13931093
2049,24,24,13937959,13938342,399,13936560,13937356,596,13937952
2050,36,36,13944702,13945284,599,13943386,13944170,525,13944695
2051,12,12,13951927,13952110,200,13950196,13950984,937,13951921
2052,8,8,13958553,13958670,133,13957005,13957798,749,13958547
2053,32,32,13965429,13965945,533,13963814,13964612,811,13965423
2054,14,14,13972422,13972638,233,13970640,13971426,989,13972415
2055,26,26,13979198,13979614,432,13977449,13978240,951,13979191
2056,6,6,13985641,13985724,99,13984259,13985054,580,13985634
2057,54,54,13992650,13993532,899,13991085,13991868,776,13992644
2058,38,38,13999193,13999809,632,13997894,13998682,504,13999186
2059,54,54,14006202,14007084,899,14004703,14005496,699,14006195
2060,34,34,14013177,14013727,566,14011512,14012310,861,14013171
2061,54,54,14019637,14020519,899,14018338,14019124,506,14019630
2062,40,40,14026746,14027395,666,14025148,14025938,802,14026740
2063,10,10,14033705,14033855,167,14031957,14032752,947,14033699
2064,2,2,14040431,14040448,33,14038783,14039566,859,14040425
2065,38,38,14047207,14047823,633,14045592,14046380,821,14047201
2066,52,52,14053767,14054616,865,14052402,14053194,567,14053761
2067,54,54,14060809,14061691,899,14059211,14060008,795,14060803
2068,40,40,14067452,14068101,666,14066037,14066822,624,14067446
2069,34,34,14074294,14074844,567,14072846,14073636,652,14074288
2070,22,22,14081220,14081570,367,14079655,14080450,764,14081214
2071,58,58,14087880,14088829,965,14086481,14087264,609,14087873
2072,60,60,14094589,14095571,999,14093291,14094078,505,14094583
2073,52,52,14101865,14102714,865,14100100,14100892,967,14101859
2074,24,24,14108291,14108674,400,14106909,14107706,578,14108284
2075,48,48,14115350,14116132,799,14113735,14114520,824,14115344
2076,38,38,14121993,14122609,632,14120544,14121334,652,14121986
2077,8,8,14129135,14129252,133,14127354,14128148,981,14129129
2078,8,8,14135511,14135628,134,14134180,14134962,543,14135505
2079,26,26,14142620,14143037,433,14140989,14141776,838,14142614
2080,48,48,14149563,14150345,799,14147798,14148590,967,14149557
2081,2,2,14156039,14156056,33,14154607,14155404,628,14156032
2082,8,8,14163098,14163215,133,14161433,14162218,874,14163092
2083,10,10,14169558,14169708,166,14168243,14169032,520,14169552
2084,22,22,14176534,14176883,366,14175052,14175846,681,14176527
2085,56,56,14183559,14184475,933,14181861,14182660,893,14183553
2086,50,50,14190036,14190851,832,14188687,14189474,555,14190029
2087,42,42,14196945,14197627,699,14195496,14196288,650,14196938
2088,58,58,14203904,14204853,966,14202306,14203102,796,14203898
2089,48,48,14210480,14211263,799,14209132,14209916,558,14210474
2090,54,54,14217389,14218272,899,14215941,14216730,653,14217383
2091,48,48,14224382,14225164,799,14222750,14223544,831,14224375
2092,60,60,14230941,14231924,999,14229559,14230358,576,14230934
2093,28,28,14237767,14238217,466,14236385,14237172,588,14237760
2094,26,26,14244577,14244993,432,14243195,14243986,584,14244570
2095,12,12,14251652,14251835,200,14250004,14250800,846,14251646
2096,14,14,14258511,14258728,234,14256830,14257614,891,14258505
2097,2,2,14264971,14264988,33,14263639,14264428,536,14264964
2098,50,50,14272213,14273029,833,14270448,14271242,965,14272207
2099,16,16,14278706,14278956,267,14277258,14278056,644,14278700
2100,54,54,14285582,14286464,899,14284084,14284870,706,14285576
2101,40,40,14292441,14293091,666,14290893,14291684,751,14292435
2102,24,24,14299284,14299667,399,14297702,14298498,779,14299277
2103,40,40,14305943,14306593,666,14304528,14305312,625,14305937
2104,58,58,14312886,14313835,965,14311337,14312126,753,14312879
2105,54,54,14319845,14320727,899,14318147,14318940,899,14319839
2106,54,54,14326571,14327453,899,14324956,14325754,811,14326565
2107,46,46,14333297,14334046,766,14331782,14332568,723,14333291
2108,8,8,14340173,14340289,133,14338591,14339382,784,14340166
2109,16,16,14346882,14347132,267,14345401,14346196,680,14346876
2110,26,26,14353791,14354208,433,14352227,14353010,776,14353786
2111,40,40,14360634,14361283,666,14359036,14359824,804,14360628
2112,60,60,14367343,14368326,999,14365845,14366638,699,14367337
2113,46,46,14374186,14374935,766,14372654,14373452,727,14374179
2114,60,60,14381062,14382044,999,14379480,14380266,789,14381055
2115,44,44,14386972,14387688,733,14386290,14386297,668,14386965
2116,46,46,14393765,14394514,766,14392316,14393111,647,14393758
2117,14,14,14400840,14401057,234,14399142,14399925,909,14400834
2118,56,56,14407483,14408399,933,14405952,14406739,738,14407477
2119,24,24,14414526,14414909,399,14412761,14413553,967,14414520
2120,40,40,14420935,14421585,666,14419570,14420367,562,14420929
2121,20,20,14428161,14428477,333,14426396,14427181,974,14428155
2122,12,12,14434804,14434987,199,14433205,14433995,802,14434797
2123,20,20,14441813,14442129,333,14440015,14440809,998,14441807
2124,16,16,14448206,14448456,266,14446841,14447623,577,14448200
2125,16,16,14455398,14455648,266,14453650,14454437,955,14455392
2126,8,8,14462207,14462324,133,14460459,14461251,950,14462201
2127,50,50,14468584,14469399,832,14467268,14468065,512,14468577
2128,6,6,14475376,14475460,100,14474094,14474879,490,14475369
2129,10,10,14482602,14482752,166,14480904,14481693,903,14482596
2130,10,10,14489211,14489361,167,14487713,14488507,698,14489205
2131,60,60,14496320,14497303,999,14494522,14495321,993,14496314
2132,8,8,14503013,14503130,133,14501348,14502135,872,14503007
2133,4,4,14509806,14509856,66,14508157,14508949,850,14509799
2134,8,8,14516648,14516765,133,14514967,14515763,879,14516642
2135,50,50,14523358,14524173,832,14521793,14522577,775,14523352
2136,14,14,14530100,14530317,233,14528602,14529391,703,14530094
2137,40,40,14536727,14537376,665,14535411,14536205,515,14536720
2138,48,48,14543536,14544318,799,14542221,14543019,511,14543530
2139,32,32,14550495,14551011,533,14549046,14549833,655,14550488
2140,46,46,14557154,14557904,766,14555856,14556647,501,14557148
2141,28,28,14564446,14564896,467,14562665,14563461,979,14564440
2142,30,30,14570790,14571272,499,14569491,14570275,508,14570783
2143,48,48,14578082,14578864,799,14576300,14577089,986,14578075
2144,30,30,14584858,14585340,499,14583110,14583903,949,14584852
2145,32,32,14591700,14592216,533,14589919,14590717,977,14591694
2146,44,44,14598060,14598776,733,14596745,14597531,523,14598054
2147,14,14,14605169,14605385,233,14603554,14604345,818,14605163
2148,16,16,14611912,14612161,266,14610363,14611159,746,14611905
2149,36,36,14618638,14619220,599,14617189,14617973,658,14618631
2150,2,2,14625763,14625780,34,14623999,14624787,971,14625758
2151,60,60,14632473,14633455,999,14630808,14631601,866,14632467
2152,14,14,14639066,14639282,233,14637617,14638415,644,14639059
2153,52,52,14645775,14646624,866,14644443,14645229,539,14645768
2154,60,60,14652534,14653517,999,14651252,14652043,484,14652527
2155,50,50,14659710,14660526,832,14658062,14658857,847,14659704
2156,10,10,14666236,14666386,167,14664888,14665671,559,14666230
2157,26,26,14672995,14673412,433,14671697,14672485,504,14672989
2158,14,14,14680021,14680238,233,14678506,14679299,716,14680015
2159,18,18,14686647,14686930,300,14685315,14686113,527,14686640
2160,38,38,14693656,14694272,633,14692141,14692927,723,14693650
2161,34,34,14700699,14701248,566,14698951,14699741,952,14700693
2162,14,14,14707525,14707741,233,14705760,14706555,964,14707519
2163,34,34,14714367,14714917,566,14712586,14713369,992,14714361
2164,26,26,14720993,14721410,433,14719395,14720183,804,14720987
2165,12,12,14727953,14728136,199,14726204,14726997,949,14727946
2166,60,60,14734462,14735444,999,14733014,14733811,645,14734456
2167,38,38,14741604,14742220,633,14739840,14740625,974,14741599
2168,10,10,14747981,14748131,166,14746649,14747439,535,14747974
2169,12,12,14754957,14755140,199,14753458,14754253,697,14754950
2170,2,2,14761666,14761683,33,14760284,14761067,592,14761659
2171,30,30,14768625,14769108,500,14767093,14767881,737,14768618
2172,44,44,14775351,14776067,733,14773903,14774695,650,14775345
2173,38,38,14782443,14783059,633,14780712,14781509,928,14782437
2174,58,58,14789053,14790002,966,14787538,14788323,724,14789047
2175,50,50,14796029,14796845,832,14794347,14795137,885,14796022
2176,10,10,14802605,14802755,166,14801157,14801951,648,14802599
2177,26,26,14809481,14809897,433,14807982,14808765,709,14809474
2178,32,32,14816257,14816773,533,14814792,14815579,672,14816251
2179,26,26,14823299,14823715,433,14821601,14822393,900,14823293
2180,52,52,14829959,14830808,865,14828410,14829207,745,14829952
2181,28,28,14836934,14837384,467,14835236,14836021,907,14836928
2182,26,26,14843544,14843960,433,14842046,14842835,703,14843538
2183,44,44,14850303,14851019,733,14848855,14849649,648,14850297
2184,44,44,14856979,14857695,733,14855664,14856463,510,14856973
2185,42,42,14863772,14864455,699,14862490,14863277,488,14863765
2186,24,24,14871064,14871447,400,14869299,14870091,967,14871058
2187,14,14,14877823,14878040,234,14876109,14876905,913,14877818
2188,20,20,14884466,14884783,333,14882935,14883719,741,14884460
2189,18,18,14891525,14891808,300,14889744,14890533,986,14891519
2190,42,42,14897885,14898568,699,14896553,14897347,531,14897878
2191,52,52,14904827,14905677,866,14903362,14904161,660,14904821
2192,48,48,14911637,14912419,799,14910188,14910975,655,14911630
2193,6,6,14918579,14918662,100,14916998,14917789,784,14918573
2194,38,38,14925488,14926104,633,14923807,14924603,879,14925482
2195,58,58,14932298,14933247,965,14930633,14931417,875,14932292
2196,18,18,14939090,14939373,300,14937442,14938231,853,14939084
2197,46,46,14945850,14946599,766,14944251,14945045,798,14945843
2198,52,52,14952842,14953691,866,14951061,14951859,977,14952836
2199,32,32,14959252,14959768,533,14957887,14958673,573,14959246
2200,48,48,14965995,14966777,799,14964696,14965487,501,14965988
2201,52,52,14973237,14974086,865,14971505,14972301,929,14973230
2202,42,42,14979646,14980329,700,14978331,14979115,525,14979640
2203,12,12,14986872,14987055,200,14985140,14985929,936,14986865
2204,28,28,14993731,14994181,466,14991950,14992743,982,14993725
2205,18,18,15000557,15000840,300,14998759,14999557,994,15000551
2206,46,46,15007266,15008016,766,15005585,15006371,889,15007260
2207,28,28,15013693,15014142,466,15012394,15013185,501,15013686
2208,56,56,15020702,15021618,932,15019204,15019999,697,15020696
2209,36,36,15027578,15028160,599,15026029,15026813,758,15027571
2210,12,12,15034603,15034787,200,15032839,15033627,971,15034598
2211,8,8,15041330,15041446,133,15039648,15040441,882,15041323
2212,54,54,15048072,15048955,899,15046457,15047255,811,15048066
2213,6,6,15055015,15055098,100,15053283,15054069,939,15055008
2214,8,8,15061491,15061608,133,15060093,15060883,602,15061485
2215,18,18,15068517,15068800,299,15066902,15067697,814,15068511
2216,22,22,15075459,15075809,366,15073728,15074511,942,15075453
2217,54,54,15082252,15083134,899,15080537,15081325,921,15082246
2218,10,10,15088928,15089078,166,15087346,15088139,782,15088921
2219,44,44,15095771,15096486,732,15094156,15094953,812,15095765
2220,42,42,15102763,15103446,699,15100982,15101767,990,15102757
2221,36,36,15109556,15110138,599,15107791,15108581,969,15109550
2222,38,38,15116165,15116781,633,15114600,15115395,764,15116159
2223,52,52,15122791,15123640,866,15121426,15122209,576,15122785
2224,38,38,15129983,15130599,633,15128235,15129023,954,15129977
2225,20,20,15136726,15137042,333,15135045,15135837,883,15136720
2226,30,30,15143269,15143752,500,15141854,15142651,612,15143263
2227,22,22,15150095,15150445,366,15148680,15149465,624,15150089
2228,48,48,15156821,15157603,799,15155489,15156279,535,15156814
2229,36,36,15163747,15164330,599,15162298,15163093,647,15163740
2230,12,12,15170456,15170639,200,15169124,15169907,542,15170449
2231,18,18,15177482,15177765,300,15175934,15176721,755,15177476
2232,20,20,15184408,15184724,333,15182743,15183535,867,15184402
2233,48,48,15191051,15191833,799,15189552,15190349,695,15191044
2234,36,36,15197910,15198492,599,15196378,15197163,740,15197903
2235,20,20,15204869,15205185,333,15203187,15203977,885,15204862
2236,42,42,15211728,15212411,699,15209997,15210791,931,15211722
2237,42,42,15218338,15219020,699,15216806,15217605,726,15218331
2238,40,40,15225247,15225896,666,15223632,15224419,822,15225241
2239,36,36,15231940,15232522,599,15230441,15231233,700,15231933
2240,12,12,15238699,15238882,200,15237250,15238047,645,15238692
2241,30,30,15245825,15246307,499,15244076,15244861,957,15245818
2242,28,28,15252417,15252867,467,15250886,15251675,736,15252411
2243,54,54,15259377,15260259,899,15257695,15258489,881,15259370
2244,48,48,15266136,15266918,799,15264504,15265303,826,15266129
2245,16,16,15272679,15272928,266,15271330,15272117,555,15272672
2246,26,26,15279521,15279938,433,15278139,15278931,583,15279514
2247,8,8,15286697,15286813,133,15284949,15285745,946,15286691
2248,48,48,15293506,15294289,799,15291775,15292559,941,15293500
2249,24,24,15299982,15300365,400,15298584,15299373,603,15299976
2250,40,40,15306692,15307341,666,15305393,15306187,498,15306685
2251,48,48,15313951,15314733,799,15312203,15313001,944,15313945
2252,6,6,15320510,15320593,100,15319029,15319815,689,15320504
2253,26,26,15327203,15327619,433,15325838,15326629,568,15327197
2254,32,32,15333996,15334512,532,15332647,15333443,546,15333989
2255,28,28,15341071,15341521,466,15339473,15340257,808,15341065
2256,2,2,15347631,15347647,33,15346282,15347071,553,15347624
2257,40,40,15354873,15355522,666,15353092,15353885,982,15354867
2258,36,36,15361616,15362198,599,15359901,15360699,911,15361610
2259,12,12,15368242,15368425,200,15366727,15367513,723,15368236
2260,54,54,15374868,15375750,899,15373536,15374327,534,15374861
2261,32,32,15382010,15382526,533,15380345,15381141,863,15382004
2262,16,16,15388620,15388869,266,15387171,15387955,658,15388613
2263,54,54,15395546,15396428,899,15393981,15394769,771,15395540
2264,50,50,15402088,15402904,833,15400790,15401583,499,15402082
2265,24,24,15409297,15409680,400,15407599,15408397,894,15409291
2266,24,24,15416123,15416506,400,15414425,15415211,906,15416117
2267,30,30,15422883,15423365,499,15421234,15422025,851,15422876
2268,42,42,15429609,15430291,699,15428044,15428839,764,15429603
2269,40,40,15436318,15436967,666,15434870,15435653,659,15436312
2270,6,6,15443127,15443211,100,15441679,15442467,654,15443121
2271,14,14,15449454,15449670,233,15448488,15448498,949,15449447
2272,56,56,15456063,15456979,933,15454515,15455312,745,15456057
2273,22,22,15462939,15463289,366,15461341,15462126,807,15462933
2274,54,54,15469582,15470464,899,15468150,15468940,635,15469575
2275,2,2,15476624,15476641,34,15474959,15475754,864,15476618
2276,6,6,15483550,15483633,100,15481785,15482568,976,15483544
2277,4,4,15490310,15490359,66,15488595,15489382,922,15490304
2278,26,26,15497102,15497518,433,15495404,15496196,900,15497096
2279,22,22,15503712,15504061,366,15502213,15503010,695,15503705
2280,10,10,15510521,15510671,166,15509039,15509824,690,15510514
2281,40,40,15517513,15518163,666,15515848,15516638,869,15517507
2282,40,40,15524123,15524772,666,15522658,15523452,665,15524117
2283,58,58,15531032,15531981,966,15529467,15530266,760,15531026
2284,10,10,15537592,15537741,166,15536293,15537080,505,15537585
2285,32,32,15544701,15545217,532,15543102,15543894,800,15544694
2286,28,28,15551626,15552076,467,15549912,15550708,913,15551621
2287,20,20,15558436,15558752,333,15556738,15557522,908,15558430
2288,12,12,15565062,15565245,200,15563547,15564336,720,15565056
2289,6,6,15571721,15571805,100,15570356,15571150,565,15571715
2290,36,36,15578780,15579363,600,15577165,15577964,810,15578774
2291,38,38,15585523,15586139,633,15583991,15584778,738,15585516
2292,30,30,15592432,15592915,500,15590801,15591592,834,15592426
2293,60,60,15598925,15599907,999,15597610,15598406,513,15598919
2294,16,16,15606134,15606384,266,15604436,15605220,908,15606128
2295,2,2,15611761,15611778,34,15611245,15611251,503,15611754
2296,28,28,15618903,15619353,467,15617272,15618065,832,15618897
2297,30,30,15625863,15626345,499,15624081,15624879,977,15625856
2298,22,22,15632455,15632805,367,15630907,15631693,756,15632449
2299,48,48,15639431,15640214,799,15637716,15638507,918,15639425
2300,46,46,15646174,15646923,766,15644526,15645321,847,15646168
2301,6,6,15653050,15653133,100,15651352,15652135,909,15653044
2302,54,54,15659842,15660725,899,15658161,15658949,887,15659836
2303,52,52,15666519,15667368,865,15664970,15665763,749,15666512
2304,20,20,15673528,15673844,333,15671779,15672577,944,15673521
2305,46,46,15680320,15681069,766,15678605,15679391,923,15680314
2306,12,12,15686946,15687129,200,15685415,15686205,735,15686940
2307,24,24,15693739,15694122,400,15692224,15693019,714,15693733
2308,54,54,15700332,15701214,899,15699050,15699833,492,15700325
2309,46,46,15707341,15708090,766,15705859,15706647,687,15707334
2310,48,48,15714134,15714916,799,15712668,15713461,666,15714127
2311,10,10,15720860,15721009,166,15719478,15720275,578,15720853
2312,26,26,15727802,15728218,433,15726304,15727089,707,15727796
2313,58,58,15734412,15735361,965,15733113,15733903,502,15734405
2314,16,16,15741587,15741837,267,15739922,15740717,864,15741581
2315,28,28,15748297,15748746,466,15746748,15747531,759,15748290
2316,16,16,15755156,15755405,266,15753557,15754345,804,15755149
2317,44,44,15761732,15762448,733,15760367,15761159,567,15761726
2318,38,38,15768957,15769573,633,15767176,15767973,978,15768951
2319,42,42,15775367,15776050,699,15774002,15774787,574,15775361
2320,56,56,15782543,15783458,932,15780811,15781601,935,15782536
2321,60,60,15789186,15790168,998,15787621,15788415,765,15789180
2322,56,56,15796228,15797144,932,15794446,15795229,992,15796221
2323,10,10,15802721,15802871,166,15801256,15802043,672,15802715
2324,32,32,15809430,15809946,533,15808065,15808857,567,15809424
2325,38,38,15816356,15816972,633,15814874,15815671,678,15816349
2326,38,38,15823482,15824098,632,15821700,15822485,990,15823475
2327,48,48,15829975,15830757,799,15828510,15829299,670,15829969
2328,56,56,15836684,15837600,932,15835319,15836113,565,15836678
2329,50,50,15843560,15844376,832,15842128,15842927,626,15843553
2330,42,42,15850303,15850985,699,15848954,15849741,555,15850296
2331,28,28,15857212,15857661,466,15855763,15856555,650,15857205
2332,40,40,15864221,15864870,666,15862573,15863369,846,15864215
2333,38,38,15871063,15871679,633,15869399,15870183,875,15871058
2334,32,32,15877906,15878422,533,15876208,15876997,903,15877900
2335,60,60,15884699,15885681,999,15883017,15883811,881,15884692
2336,50,50,15891192,15892007,832,15889826,15890625,560,15891185
2337,22,22,15898367,15898717,366,15896652,15897439,922,15898361
2338,10,10,15905176,15905326,167,15903462,15904253,918,15905171
2339,60,60,15911753,15912735,999,15910271,15911067,679,15911746
2340,16,16,15918462,15918712,266,15917097,15917881,575,15918456
2341,20,20,15925438,15925754,333,15923906,15924695,736,15925431
2342,12,12,15932230,15932414,200,15930715,15931509,715,15932224
2343,48,48,15938940,15939722,799,15937525,15938323,611,15938934
2344,52,52,15945882,15946731,866,15944351,15945137,739,15945876
2345,22,22,15952542,15952891,366,15951160,15951951,584,15952535
2346,8,8,15959734,15959851,133,15957969,15958765,963,15959728
2347,38,38,15966110,15966726,633,15964795,15965579,525,15966104
2348,54,54,15973336,15974218,899,15971604,15972393,936,15973329
2349,42,42,15979962,15980645,699,15978414,15979207,749,15979956
2350,16,16,15986705,15986954,266,15985223,15986021,677,15986698
2351,40,40,15993564,15994213,666,15992049,15992835,723,15993558
2352,16,16,16000340,16000590,266,15998858,15999649,684,16000333
2353,48,48,16007066,16007849,799,16005668,16006463,597,16007060
2354,22,22,16013975,16014325,366,16012493,16013277,691,16013968
2355,20,20,16020984,16021301,333,16019303,16020091,887,16020978
2356,42,42,16027444,16028127,699,16026112,16026905,532,16027437
2357,14,14,16034669,16034886,234,16032921,16033719,944,16034663
2358,32,32,16041329,16041845,533,16039747,16040533,789,16041322
2359,6,6,16048122,16048205,99,16046557,16047347,769,16048116
2360,18,18,16055031,16055314,299,16053366,16054161,864,16055025
2361,20,20,16061907,16062223,333,16060192,16060975,926,16061901
2362,38,38,16068416,16069032,633,16067001,16067789,621,16068410
2363,14,14,16075542,16075758,233,16073810,16074603,932,16075535
2364,12,12,16082018,16082201,200,16080620,16081417,595,16082012
2365,60,60,16088894,16089876,999,16087446,16088231,657,16088888
2366,8,8,16095886,16096003,134,16094255,16095045,835,16095880
2367,38,38,16102413,16103029,632,16101064,16101859,547,16102406
2368,4,4,16109472,16109522,66,16107890,16108673,792,16109465
2369,10,10,16116048,16116198,166,16114699,16115487,554,16116041
2370,14,14,16123173,16123390,234,16121509,16122301,867,16123168
2371,44,44,16129683,16130399,733,16128318,16129115,562,16129677
2372,10,10,16136676,16136825,166,16135144,16135929,740,16136669
2373,50,50,16143735,16144550,832,16141953,16142743,985,16143728
2374,54,54,16150294,16151176,899,16148762,16149557,730,16150287
2375,54,54,16156954,16157836,899,16155588,16156371,576,16156947
2376,50,50,16164112,16164928,833,16162398,16163185,922,16164107
2377,32,32,16170622,16171138,533,16169207,16169999,617,16170616
2378,14,14,16177348,16177565,233,16176016,16176813,528,16177341
2379,42,42,16184257,16184940,700,16182842,16183627,624,16184251
2380,22,22,16191200,16191549,366,16189651,16190441,752,16191193
2381,52,52,16198009,16198858,866,16196461,16197255,748,16198003
2382,20,20,16204585,16204902,333,16203270,16204069,510,16204579
2383,10,10,16211444,16211594,167,16210096,16210883,555,16211438
2384,38,38,16218270,16218886,633,16216905,16217697,567,16218264
2385,40,40,16225496,16226145,666,16223715,16224511,979,16225490
2386,36,36,16231822,16232405,600,16230540,16231325,490,16231815
2387,32,32,16239015,16239531,532,16237350,16238139,870,16239009
2388,2,2,16245607,16245624,34,16244159,16244953,648,16245601
2389,32,32,16252583,16253099,533,16250968,16251767,810,16252577
2390,14,14,16259243,16259459,233,16257794,16258581,655,16259236
2391,14,14,16266352,16266568,233,16264604,16265395,951,16266346
2392,14,14,16272828,16273044,233,16271413,16272209,613,16272822
2393,4,4,16279937,16279987,67,16278239,16279023,908,16279931
2394,40,40,16286546,16287196,666,16285048,16285837,703,16286540
2395,60,60,16293206,16294188,999,16291857,16292651,548,16293199
2396,42,42,16299998,16300681,700,16298667,16299465,527,16299992
2397,30,30,16306874,16307357,500,16305493,16306279,589,16306868
2398,58,58,16313850,16314799,966,16312302,16313093,751,16313844
2399,52,52,16320560,16321409,865,16319111,16319907,646,16320553
2400,28,28,16327369,16327818,466,16325937,16326721,641,16327362
2401,58,58,16334328,16335277,966,16332746,16333535,786,16334321
2402,6,6,16341154,16341237,100,16339556,16340349,799,16341148
2403,58,58,16348096,16349045,966,16346365,16347163,927,16348090
2404,36,36,16354839,16355422,599,16353191,16353977,856,16354833
2405,30,30,16361349,16361831,499,16360000,16360791,551,16361342
2406,28,28,16368408,16368857,466,16366809,16367605,796,16368401
2407,28,28,16375333,16375783,467,16373635,16374419,908,16375327
2408,44,44,16381893,16382609,733,16380445,16381233,654,16381887
2409,48,48,16389035,16389818,799,16387254,16388047,982,16389029
2410,14,14,16395678,16395895,233,16394063,16394861,811,16395672
2411,8,8,16402637,16402754,133,16400889,16401675,956,16402631
2412,26,26,16409247,16409663,433,16407698,16408489,751,16409240
2413,12,12,16416156,16416339,200,16414508,16415303,847,16416150
2414,46,46,16422782,16423531,766,16421334,16422117,659,16422776
2415,48,48,16429658,16430440,799,16428143,16428931,721,16429652
2416,4,4,16436517,16436567,67,16434952,16435745,766,16436511
2417,40,40,16443543,16444192,666,16441761,16442559,977,16443536
2418,28,28,16450119,16450569,466,16448587,16449373,739,16450112
2419,44,44,16456745,16457461,733,16455397,16456187,552,16456739
2420,34,34,16463987,16464537,566,16462206,16463001,980,16463981
2421,26,26,16470447,16470863,433,16469032,16469815,626,16470441
2422,42,42,16477156,16477839,700,16475841,16476629,521,16477150
2423,26,26,16484215,16484632,433,16482650,16483443,766,16484209
2424,56,56,16490958,16491874,932,16489460,16490257,695,16490952
2425,52,52,16497618,16498467,865,16496286,16497071,540,16497611
2426,60,60,16504843,16505825,999,16503095,16503885,952,16504837
2427,32,32,16511586,16512102,533,16509904,16510699,880,16511579
2428,30,30,16518062,16518545,500,16516730,16517513,542,16518055
2429,8,8,16524838,16524955,133,16523540,16524327,505,16524832
2430,56,56,16532080,16532996,933,16530349,16531141,933,16532074
2431,24,24,16538923,16539306,399,16537158,16537955,962,16538917
2432,6,6,16545549,16545632,100,16543984,16544769,774,16545543
2433,40,40,16552491,16553141,666,16550793,16551583,902,16552485
2434,6,6,16559018,16559101,100,16557603,16558397,615,16559012
2435,40,40,16566027,16566676,666,16564429,16565211,810,16566021
2436,60,60,16572586,16573569,999,16571238,16572025,555,16572580
2437,10,10,16579795,16579945,167,16578047,16578839,950,16579789
2438,56,56,16586405,16587320,932,16584856,16585653,745,16586398
2439,4,4,16593331,16593380,66,16591682,16592467,857,16593324
2440,36,36,16599940,16600523,599,16598492,16599281,653,16599934
2441,30,30,16606899,16607382,500,16605301,16606095,798,16606893
2442,42,42,16613825,16614508,699,16612110,16612909,910,16613819
2443,34,34,16620551,16621100,566,16618936,16619723,822,16620545
2444,36,36,16627094,16627677,599,16625745,16626537,550,16627087
2445,2,2,16634103,16634120,33,16632555,16633351,746,16634097
2446,40,40,16640929,16641578,666,16639381,16640165,758,16640923
2447,22,22,16647855,16648204,366,16646190,16646979,870,16647849
2448,40,40,16654314,16654964,666,16652999,16653793,515,16654308
2449,22,22,16661407,16661756,366,16659808,16660607,793,16661400
2450,22,22,16667966,16668316,367,16666634,16667421,538,16667959
2451,12,12,16674859,16675042,200,16673444,16674235,618,16674853
2452,56,56,16681635,16682550,932,16680253,16681049,579,16681628
2453,18,18,16688860,16689143,300,16687079,16687863,991,16688854
2454,24,24,16695653,16696036,400,16693888,16694677,970,16695647
2455,56,56,16702113,16703028,932,16700697,16701491,615,16702106
2456,22,22,16709272,16709621,366,16707507,16708305,961,16709266
2457,30,30,16715781,16716264,500,16714333,16715119,656,16715775
2458,6,6,16722890,16722973,100,16721142,16721933,951,16722884
2459,18,18,16729566,16729849,300,16727951,16728747,813,16729560
2460,8,8,16736559,16736675,133,16734777,16735561,991,16736552
2461,20,20,16742934,16743250,333,16741585,16742375,552,16742927
2462,26,26,16749827,16750243,432,16748395,16749189,631,16749820
2463,42,42,16756736,16757418,699,16755204,16756003,726,16756729
2464,6,6,16763711,16763795,100,16762030,16762817,888,16763705
2465,10,10,16770521,16770671,166,16768839,16769631,883,16770514
2466,12,12,16777313,16777497,200,16775649,16776445,863,16777308
2467,26,26,16784039,16784456,433,16782474,16783259,773,16784032
2468,40,40,16790716,16791365,666,16789284,16790073,635,16790708
2469,36,36,16797558,16798141,600,16796093,16796887,665,16797552
2470,14,14,16804434,16804650,233,16802902,16803701,727,16804428
2471,10,10,16811360,16811510,166,16809728,16810515,837,16811352
2472,24,24,16817986,16818369,400,16816538,16817329,651,16817980
2473,6,6,16825095,16825178,100,16823347,16824143,945,16825088
2474,22,22,16831921,16832271,366,16830173,16830957,959,16831916
2475,16,16,16838664,16838913,266,16836982,16837771,885,16838656
2476,8,8,16845290,16845406,133,16843791,16844585,699,16845284
2477,26,26,16852216,16852632,432,16850601,16851399,811,16852210
2478,10,10,16858742,16858892,166,16857427,16858213,523,16858736
2479,14,14,16865584,16865801,233,16864236,16865027,551,16865578
2480,42,42,16872577,16873259,699,16871045,16871841,729,16872570
2481,30,30,16879652,16880135,500,16877871,16878655,991,16879646
2482,32,32,16886162,16886678,533,16884680,16885469,687,16886156
2483,24,24,16892905,16893288,399,16891490,16892283,617,16892900
2484,12,12,16899764,16899947,200,16898299,16899097,661,16899758
2485,10,10,16906623,16906773,167,16905125,16905911,705,16906616
2486,54,54,16913582,16914465,899,16911934,16912725,851,16913576
2487,30,30,16920275,16920758,500,16918743,16919539,729,16920268
2488,54,54,16927168,16928050,899,16925569,16926353,807,16927160
2489,56,56,16933977,16934893,932,16932379,16933167,805,16933972
2490,30,30,16940936,16941419,500,16939188,16939981,949,16940930
2491,14,14,16947346,16947562,233,16945997,16946795,545,16947340
2492,6,6,16954205,16954288,100,16952823,16953609,589,16954198
2493,18,18,16960998,16961281,299,16959632,16960423,569,16960992
2494,36,36,16968140,16968723,599,16966442,16967237,897,16968134
2495,32,32,16974966,16975482,533,16973268,16974051,909,16974960
2496,20,20,16981825,16982141,333,16980077,16980865,955,16981820
2497,30,30,16988468,16988951,499,16986886,16987679,781,16988460
2498,10,10,16995111,16995260,166,16993696,16994493,611,16995104
2499,14,14,17001837,17002053,233,17000521,17001307,523,17001830
2500,20,20,17009012,17009329,333,17007331,17008121,885,17009006
2501,54,54,17015572,17016454,899,17014140,17014935,629,17015564
2502,10,10,17022481,17022631,166,17020966,17021749,727,17022476
2503,54,54,17029340,17030223,899,17027775,17028563,771,17029334
2504,54,54,17036316,17037198,899,17034585,17035377,933,17036310
2505,54,54,17043042,17043924,899,17041394,17042191,845,17043036
2506,4,4,17049951,17050001,67,17048220,17049005,939,17049944
2507,32,32,17056810,17057327,533,17055029,17055819,985,17056804
2508,50,50,17063253,17064069,833,17061838,17062633,615,17063248
2509,10,10,17070362,17070512,167,17068664,17069447,909,17070356
2510,18,18,17077188,17077471,300,17075474,17076261,923,17077184
2511,24,24,17083998,17084381,399,17082283,17083075,917,17083992
2512,54,54,17090807,17091689,899,17089092,17089889,911,17090800
2513,58,58,17097333,17098282,966,17095918,17096703,625,17097328
2514,36,36,17104409,17104992,599,17102727,17103517,885,17104402
2515,26,26,17111201,17111618,433,17109537,17110331,865,17111196
2516,48,48,17117928,17118710,799,17116363,17117145,777,17117922
2517,34,34,17124787,17125336,566,17123172,17123959,821,17124780
2518,44,44,17131646,17132362,733,17129981,17130773,867,17131640
2519,56,56,17138505,17139421,933,17136790,17137587,913,17138500
2520,20,20,17145381,17145697,333,17143616,17144401,975,17145376
2521,54,54,17151891,17152773,899,17150426,17151215,669,17151884
2522,46,46,17158916,17159666,766,17157235,17158029,881,17158910
2523,6,6,17165809,17165892,100,17164044,17164843,961,17165804
2524,18,18,17172335,17172618,300,17170870,17171657,671,17172328
2525,36,36,17179328,17179910,599,17177679,17178471,849,17179320
2526,30,30,17186220,17186703,500,17184489,17185285,929,17186214
2527,8,8,17192713,17192830,133,17191315,17192099,609,17192708
2528,22,22,17199905,17200255,367,17198124,17198913,987,17199900
2529,2,2,17206332,17206348,33,17204933,17205727,597,17206324
2530,54,54,17213441,17214323,899,17211743,17212541,895,17213436
2531,50,50,17219867,17220683,832,17218568,17219355,505,17219860
2532,40,40,17227026,17227675,666,17225378,17226169,851,17227020
2533,56,56,17233918,17234834,933,17232187,17232983,929,17233912
2534,2,2,17240395,17240411,33,17239013,17239797,591,17240388
2535,6,6,17247570,17247654,100,17245822,17246611,953,17247564
2536,44,44,17254296,17255012,733,17252632,17253425,867,17254292
2537,30,30,17260789,17261272,500,17259441,17260239,545,17260784
2538,8,8,17267565,17267682,134,17266267,17267053,507,17267560
2539,44,44,17274574,17275290,733,17273076,17273867,701,17274568
2540,58,58,17281583,17282532,966,17279885,17280681,895,17281576
2541,6,6,17288493,17288576,100,17286711,17287495,991,17288486
2542,36,36,17295202,17295785,599,17293521,17294309,887,17295196
2543,52,52,17301845,17302694,866,17300330,17301123,717,17301840
2544,8,8,17308521,17308637,133,17307139,17307937,577,17308514
2545,6,6,17315447,17315530,100,17313965,17314751,689,17315440
2546,42,42,17322472,17323155,700,17320774,17321565,901,17322466
