TRL_NUMBER,TRL_STOP_SIGNAL_DELAY,TRL_TARG_SSD_VRT_RFRSH_COUNT,TRL_TARG_ON_TIME,TRL_STOP_SIGNAL_TIME,TRL_STOP_SIGNAL_DURATION,TRL_FIX_ON_TIME,TRL_FIX_ACQ_TIME,TRL_FIX_HOLD_TIME,TRL_FIXATED_TIME
1,20,20,2710,3026,349,1062,1859,836,2695
2,48,48,9453,10235,815,7888,8673,765,9438
3,54,54,16062,16945,915,14697,15487,560,16047
4,28,28,23121,23571,482,21506,22301,805,23106
5,60,60,29881,30863,1016,28332,29115,750,29865
6,46,46,36740,37489,782,35142,35929,796,36725
7,52,52,43599,44448,882,41951,42743,841,43584
8,42,42,50109,50791,716,48760,49557,536,50093
9,32,32,57134,57651,549,55586,56371,748,57119
10,48,48,63744,64526,816,62395,63185,543,63728
11,24,24,70703,71086,416,69205,69999,689,70688
12,12,12,76647,76830,214,0,76030,603,76633
13,56,56,83622,84538,949,82057,82844,763,83607
14,24,24,90182,90565,416,88867,89658,509,90167
15,6,6,97174,97258,116,95676,96472,687,97159
16,40,40,104067,104716,682,102502,103286,766,104052
17,32,32,111026,111542,549,109311,110100,911,111011
18,36,36,117502,118085,616,116120,116914,573,117487
19,16,16,124695,124944,282,122930,123728,952,124680
20,30,30,131088,131570,515,129756,130542,531,131073
21,30,30,138130,138613,515,136565,137356,759,138115
22,8,8,144773,144889,150,143374,144170,587,144757
23,60,60,151948,152931,1015,150200,150984,949,151933
24,54,54,158724,159607,915,157009,157798,911,158709
25,56,56,165500,166416,948,163819,164612,874,165486
26,14,14,172343,172559,249,170628,171426,902,172328
27,16,16,179086,179335,282,177454,178240,831,179071
28,14,14,185778,185995,249,184263,185054,709,185763
29,10,10,192438,192588,182,191073,191868,555,192423
30,38,38,199463,200079,648,197899,198682,767,199449
31,42,42,206473,207155,715,204708,205496,962,206458
32,34,34,212100,212649,583,211517,211527,557,212084
33,32,32,218942,219458,549,217544,218341,586,218927
34,12,12,225901,226085,215,224370,225155,732,225887
35,6,6,232894,232977,116,231179,231969,910,232879
36,4,4,239487,239537,83,237988,238783,688,239471
37,6,6,246562,246646,116,244814,245597,950,246547
38,28,28,253072,253522,482,251624,252411,646,253057
39,56,56,260064,260980,948,258433,259225,825,260050
40,54,54,267040,267923,915,265242,266039,986,267025
41,28,28,273683,274133,482,272068,272853,815,273668
42,52,52,280659,281508,882,278877,279667,977,280644
43,56,56,287218,288134,948,285687,286481,723,287204
44,4,4,293994,294044,83,292496,293295,684,293979
45,12,12,300720,300904,216,299322,300109,596,300705
46,16,16,307530,307779,283,306131,306923,591,307514
47,18,18,314555,314838,316,312940,313737,803,314540
48,6,6,321381,321465,116,319766,320551,815,321366
49,34,34,328007,328557,582,326576,327365,628,327993
50,18,18,334983,335266,316,333385,334179,789,334968
51,26,26,341826,342242,449,340194,340993,818,341811
52,48,48,348685,349468,815,347020,347807,863,348670
53,26,26,355161,355578,449,353829,354621,525,355146
54,32,32,362054,362570,549,360639,361435,604,362039
55,2,2,368813,368830,50,367465,368249,549,368798
56,12,12,375639,375822,216,374274,375063,561,375624
57,56,56,382399,383314,949,381083,381877,506,382383
58,22,22,389324,389674,382,387893,388691,619,389310
59,24,24,396300,396683,415,394719,395505,781,396286
60,20,20,403209,403526,348,401528,402319,876,403195
61,54,54,409719,410601,915,408337,409133,571,409704
62,28,28,416661,417111,483,415163,415947,699,416646
63,48,48,423537,424320,815,421972,422761,761,423522
64,30,30,430147,430630,515,428782,429575,557,430132
65,46,46,436973,437722,782,435591,436389,569,436958
66,22,22,443915,444265,382,442417,443203,697,443900
67,4,4,450541,450591,83,449226,450017,509,450526
68,24,24,457434,457817,416,456035,456831,587,457418
69,54,54,464210,465092,916,462861,463645,549,464194
70,22,22,471086,471435,382,469671,470459,612,471071
71,20,20,478195,478511,349,476480,477273,907,478180
72,40,40,484921,485570,682,483289,484087,819,484906
73,50,50,491880,492696,848,490115,490901,964,491865
74,52,52,498423,499272,883,496924,497715,692,498407
75,14,14,505165,505382,249,503734,504529,622,505151
76,42,42,512274,512957,715,510560,511343,917,512260
77,54,54,518884,519766,915,517369,518157,712,518869
78,34,34,525843,526392,582,524178,524971,857,525828
79,10,10,532453,532602,183,530987,531785,652,532437
80,44,44,539179,539894,749,537813,538599,564,539163
81,4,4,545955,546005,82,544623,545413,527,545940
82,8,8,553064,553180,149,551432,552227,822,553049
83,44,44,560056,560772,749,558258,559041,1000,560041
84,28,28,566399,566849,482,565067,565855,529,566384
85,52,52,573675,574524,882,571876,572669,990,573659
86,6,6,580151,580234,116,578686,579483,653,580136
87,44,44,586960,587676,749,585512,586297,648,586945
88,54,54,594069,594951,915,592321,593111,943,594054
89,56,56,600579,601494,949,599130,599925,638,600563
90,44,44,607721,608437,749,605956,606739,967,607706
91,46,46,614514,615263,782,612765,613553,945,614498
92,16,16,621223,621473,282,619575,620367,841,621208
93,26,26,627899,628315,449,626384,627181,703,627884
94,6,6,634592,634675,116,633210,633995,582,634577
95,44,44,641767,642483,749,640019,640809,943,641752
96,4,4,648610,648660,82,646829,647623,973,648596
97,26,26,655020,655436,450,653654,654437,567,655004
98,24,24,662229,662611,415,660464,661251,963,662214
99,8,8,668888,669005,149,667273,668065,808,668873
100,48,48,675681,676463,816,674082,674879,786,675665
101,18,18,682340,682623,316,680908,681693,632,682325
102,48,48,689449,690232,814,687718,688507,928,689435
103,60,60,695959,696941,1015,694527,695321,623,695944
104,60,60,703084,704067,1015,701336,702135,934,703069
105,14,14,709927,710143,249,708162,708949,963,709912
106,6,6,716703,716786,116,714971,715763,925,716688
107,22,22,723296,723645,382,721781,722577,704,723281
108,8,8,730205,730321,149,728607,729391,799,730190
109,30,30,737081,737564,515,735416,736205,861,737066
110,6,6,743740,743823,116,742225,743019,706,743725
111,20,20,750699,751016,349,749034,749833,851,750684
112,20,20,757475,757792,349,755860,756647,813,757460
113,60,60,764035,765017,1015,762670,763461,559,764020
114,12,12,771160,771344,215,769479,770275,871,771146
115,50,50,777770,778586,848,776305,777089,666,777755
116,38,38,784529,785145,649,783114,783903,611,784514
117,18,18,791272,791555,317,789923,790717,539,791256
118,50,50,798398,799213,848,796733,797531,852,798383
119,30,30,805240,805723,515,803559,804345,881,805226
120,40,40,811700,812349,682,810368,811159,526,811685
121,46,46,818792,819541,782,817177,817973,804,818777
122,56,56,825618,826534,948,824003,824787,816,825603
123,34,34,832278,832827,583,830812,831601,661,832262
124,60,60,839020,840003,1015,837622,838415,590,839005
125,6,6,845963,846046,116,844431,845229,719,845948
126,36,36,852705,853288,616,851257,852043,647,852690
127,14,14,859714,859931,250,858066,858857,842,859699
128,26,26,866224,866640,449,864876,865671,538,866209
129,50,50,873333,874149,848,871701,872485,833,873318
130,58,58,879909,880858,982,878511,879299,595,879894
131,34,34,885936,886485,583,885320,885330,590,885920
132,56,56,892662,893578,948,891347,892144,503,892647
133,42,42,899721,900404,715,898173,898958,748,899706
134,48,48,906464,907246,815,904982,905772,677,906449
135,2,2,913306,913323,50,911791,912586,705,913291
136,10,10,920266,920415,183,918617,919400,850,920250
137,34,34,926892,927441,582,925427,926214,663,926877
138,42,42,933651,934334,715,932236,933028,608,933636
139,16,16,940627,940876,282,939045,939842,770,940612
140,52,52,947652,948502,881,945871,946656,982,947638
141,22,22,954345,954695,383,952680,953470,860,954330
142,48,48,960905,961687,815,959490,960284,606,960890
143,24,24,967964,968347,415,966316,967098,851,967949
144,2,2,974623,974640,50,973125,973912,696,974608
145,4,4,981649,981699,83,979934,980726,908,981634
146,38,38,988425,989041,649,986743,987540,870,988410
147,20,20,994985,995301,350,993569,994354,615,994969
148,46,46,1001927,1002676,782,1000379,1001168,744,1001912
149,44,44,1008720,1009436,748,1007188,1007982,723,1008705
150,2,2,1015762,1015779,49,1013997,1014796,951,1015747
151,56,56,1022455,1023370,948,1020823,1021610,830,1022440
152,10,10,1029381,1029530,183,1027632,1028424,941,1029365
153,46,46,1036040,1036789,782,1034442,1035238,787,1036025
154,46,46,1042982,1043732,781,1041268,1042052,916,1042968
155,16,16,1049675,1049925,283,1048077,1048866,794,1049660
156,4,4,1056668,1056718,82,1054886,1055680,973,1056653
157,40,40,1063027,1063677,681,1061696,1062494,519,1063013
158,22,22,1069853,1070203,383,1068521,1069308,530,1069838
159,24,24,1076862,1077245,415,1075331,1076122,726,1076848
160,34,34,1083605,1084155,582,1082140,1082936,654,1083590
161,48,48,1090464,1091247,816,1088966,1089750,699,1090449
162,34,34,1097174,1097723,583,1095775,1096564,594,1097158
163,44,44,1104133,1104849,748,1102585,1103378,740,1104118
164,56,56,1110792,1111708,949,1109394,1110192,585,1110777
165,60,60,1117652,1118634,1014,1116220,1117006,631,1117637
166,16,16,1124677,1124927,283,1123029,1123820,842,1124662
167,30,30,1131403,1131886,516,1129838,1130634,754,1131388
168,48,48,1138063,1138845,816,1136664,1137448,599,1138047
169,32,32,1145072,1145588,549,1143474,1144262,795,1145057
170,8,8,1151881,1151998,149,1150283,1151076,790,1151866
171,12,12,1158441,1158624,216,1157092,1157890,535,1158425
172,34,34,1165650,1166199,582,1163918,1164704,931,1165635
173,16,16,1172159,1172409,283,1170727,1171518,626,1172144
174,44,44,1179085,1179801,749,1177537,1178332,738,1179070
175,4,4,1185894,1185944,82,1184363,1185146,734,1185880
176,58,58,1192554,1193503,981,1191172,1191960,579,1192539
177,12,12,1199446,1199629,216,1197981,1198774,657,1199431
178,10,10,1206389,1206539,183,1204790,1205588,785,1206373
179,38,38,1212998,1213614,649,1211616,1212402,581,1212983
180,12,12,1219841,1220024,216,1218426,1219216,610,1219826
181,44,44,1226783,1227499,749,1225235,1226030,738,1226768
182,22,22,1233642,1233992,382,1232061,1232844,784,1233628
183,52,52,1240652,1241501,881,1238870,1239658,979,1240637
184,32,32,1247361,1247877,549,1245679,1246472,874,1247346
185,30,30,1253970,1254453,515,1252489,1253286,670,1253956
186,58,58,1260980,1261928,981,1259315,1260100,865,1260965
187,34,34,1267589,1268138,582,1266124,1266914,660,1267574
188,12,12,1274681,1274864,216,1272933,1273728,938,1274666
189,28,28,1281291,1281740,482,1279759,1280542,734,1281276
190,8,8,1288350,1288466,149,1286568,1287356,979,1288335
191,28,28,1294959,1295409,482,1293378,1294170,775,1294945
192,24,24,1301586,1301968,416,1300187,1300984,586,1301570
193,14,14,1308744,1308961,249,1307013,1307798,932,1308730
194,10,10,1315287,1315437,183,1313822,1314612,660,1315272
195,34,34,1322196,1322746,582,1320632,1321426,756,1322182
196,40,40,1329206,1329855,683,1327457,1328240,950,1329190
197,36,36,1335765,1336348,615,1334267,1335054,696,1335750
198,44,44,1342708,1343423,748,1341076,1341868,825,1342693
199,6,6,1349300,1349384,116,1347885,1348682,603,1349285
200,20,20,1356243,1356559,349,1354711,1355496,732,1356228
201,56,56,1363185,1364101,948,1361521,1362310,861,1363171
202,54,54,1369911,1370794,914,1368330,1369124,773,1369897
203,20,20,1376621,1376937,349,1375139,1375938,668,1376606
204,16,16,1383380,1383630,283,1381965,1382752,613,1383365
205,10,10,1390456,1390606,182,1388774,1389566,875,1390441
206,36,36,1397348,1397931,615,1395584,1396380,954,1397334
207,2,2,1403841,1403858,49,1402410,1403194,633,1403827
208,36,36,1410767,1411350,616,1409219,1410008,744,1410752
209,14,14,1417343,1417560,249,1416028,1416822,506,1417328
210,28,28,1424186,1424635,483,1422837,1423636,534,1424170
211,34,34,1431012,1431561,583,1429663,1430450,546,1430996
212,24,24,1437838,1438221,415,1436473,1437264,559,1437823
213,46,46,1444797,1445546,782,1443282,1444078,704,1444782
214,22,22,1451889,1452239,382,1450108,1450892,983,1451875
215,58,58,1458515,1459464,982,1456917,1457706,794,1458500
216,4,4,1465308,1465358,83,1463726,1464520,773,1465293
217,26,26,1471951,1472367,449,1470536,1471334,602,1471936
218,54,54,1478877,1479759,915,1477362,1478148,714,1478862
219,32,32,1485869,1486385,549,1484171,1484962,892,1485854
220,20,20,1492662,1492978,349,1490980,1491776,871,1492647
221,4,4,1499404,1499454,83,1497806,1498590,799,1499389
222,34,34,1506081,1506630,583,1504615,1505404,661,1506065
223,58,58,1512990,1513939,981,1511425,1512218,757,1512975
224,42,42,1520032,1520715,715,1518234,1519032,985,1520017
225,2,2,1526542,1526558,49,1525060,1525846,681,1526527
226,48,48,1533434,1534217,815,1531869,1532660,759,1533419
227,22,22,1540010,1540360,382,1538679,1539474,522,1539996
228,54,54,1546886,1547769,915,1545504,1546288,583,1546871
229,42,42,1553812,1554495,715,1552314,1553102,695,1553797
230,14,14,1560904,1561121,249,1559123,1559916,974,1560890
231,56,56,1567297,1568213,949,1565932,1566730,552,1567282
232,60,60,1574090,1575072,1015,1572758,1573544,531,1574075
233,38,38,1581299,1581915,648,1579568,1580358,927,1581285
234,24,24,1587775,1588158,416,1586377,1587172,588,1587760
235,2,2,1594518,1594535,49,1593203,1593986,517,1594503
236,30,30,1601377,1601860,516,1600012,1600800,562,1601362
237,44,44,1608220,1608936,749,1606821,1607614,590,1608204
238,14,14,1615229,1615445,249,1613631,1614428,786,1615214
239,40,40,1622038,1622687,681,1620457,1621242,782,1622024
240,48,48,1628881,1629663,815,1627266,1628056,810,1628866
241,12,12,1635590,1635773,216,1634075,1634870,705,1635575
242,60,60,1642283,1643265,1015,1640901,1641684,584,1642268
243,40,40,1649125,1649775,682,1647710,1648498,612,1649110
244,26,26,1655935,1656351,449,1654520,1655312,608,1655920
245,42,42,1662711,1663393,715,1661329,1662126,570,1662696
246,18,18,1669920,1670203,315,1668155,1668940,965,1669905
247,40,40,1676462,1677112,682,1674964,1675754,693,1676447
248,26,26,1683455,1683871,449,1681773,1682568,872,1683440
249,34,34,1690164,1690714,582,1688599,1689382,767,1690149
250,40,40,1696924,1697573,682,1695409,1696196,713,1696909
251,34,34,1703983,1704532,582,1702218,1703010,958,1703968
252,44,44,1710825,1711541,749,1709027,1709824,986,1710810
253,48,48,1717568,1718350,815,1715853,1716638,915,1717553
254,10,10,1723428,1723578,184,1722662,1722669,743,1723412
255,28,28,1730138,1730587,483,1728689,1729483,639,1730122
256,44,44,1737213,1737929,748,1735499,1736297,902,1737199
257,36,36,1743806,1744389,616,1742324,1743111,680,1743791
258,16,16,1750599,1750849,282,1749134,1749925,659,1750584
259,52,52,1757325,1758174,882,1755943,1756739,571,1757310
260,48,48,1764567,1765349,815,1762769,1763553,999,1764552
261,22,22,1771010,1771360,382,1769578,1770367,628,1770995
262,10,10,1777753,1777903,182,1776388,1777181,557,1777738
263,34,34,1784712,1785261,582,1783197,1783995,702,1784697
264,22,22,1791388,1791738,382,1790023,1790809,564,1791373
265,54,54,1798146,1799029,915,1796831,1797623,508,1798131
266,20,20,1805005,1805322,349,1803640,1804437,553,1804990
267,50,50,1812198,1813013,848,1810466,1811251,932,1812183
268,38,38,1818774,1819390,649,1817276,1818065,694,1818759
269,22,22,1825483,1825833,383,1824085,1824879,589,1825468
270,60,60,1832459,1833441,1015,1830894,1831693,751,1832444
271,52,52,1839402,1840251,881,1837720,1838507,880,1839387
272,52,52,1845911,1846760,882,1844529,1845321,575,1845896
273,52,52,1852687,1853536,882,1851339,1852135,537,1852672
274,38,38,1859746,1860362,648,1858165,1858949,783,1859732
275,36,36,1866322,1866905,616,1864974,1865763,544,1866307
276,20,20,1873248,1873565,349,1871783,1872577,656,1873233
277,10,10,1880274,1880424,182,1878592,1879391,868,1880259
278,36,36,1886850,1887433,615,1885418,1886205,630,1886835
279,40,40,1893976,1894625,682,1892228,1893019,942,1893961
280,44,44,1900452,1901168,749,1899037,1899833,604,1900437
281,42,42,1907328,1908011,715,1905863,1906647,666,1907313
282,56,56,1914137,1915053,949,1912672,1913461,661,1914122
283,54,54,1920913,1921796,915,1919481,1920275,623,1920898
284,50,50,1928022,1928838,848,1926291,1927089,919,1928008
285,54,54,1934732,1935614,915,1933117,1933903,814,1934717
286,58,58,1941291,1942240,982,1939926,1940717,559,1941276
287,42,42,1948117,1948800,715,1946735,1947531,571,1948102
288,60,60,1955193,1956175,1015,1953561,1954345,833,1955178
289,6,6,1962152,1962235,116,1960370,1961159,978,1962137
290,24,24,1968495,1968878,416,1967180,1967973,507,1968480
291,2,2,1975687,1975704,49,1973989,1974787,885,1975672
292,8,8,1982247,1982363,149,1980815,1981601,631,1982232
293,30,30,1989189,1989672,516,1987624,1988415,759,1989174
294,40,40,1996098,1996748,682,1994433,1995229,854,1996083
295,8,8,2002924,2003041,149,2001259,2002043,866,2002909
296,46,46,2009484,2010233,782,2008069,2008857,612,2009469
297,8,8,2016493,2016609,149,2014878,2015671,807,2016478
298,32,32,2023369,2023885,549,2021687,2022485,869,2023354
299,46,46,2030145,2030894,782,2028513,2029299,831,2030130
300,30,30,2036788,2037270,515,2035323,2036113,660,2036773
301,34,34,2043880,2044429,582,2042132,2042927,938,2043865
302,8,8,2050539,2050656,149,2048958,2049741,784,2050525
303,18,18,2057382,2057665,316,2055767,2056555,812,2057367
304,54,54,2064058,2064940,915,2062576,2063369,674,2064043
305,44,44,2070834,2071550,749,2069386,2070183,636,2070819
306,28,28,2077543,2077993,482,2076212,2076997,532,2077529
307,18,18,2084652,2084935,315,2083021,2083811,827,2084638
308,16,16,2091595,2091845,282,2089830,2090625,955,2091580
309,48,48,2098005,2098787,816,2096656,2097439,550,2097989
310,12,12,2105180,2105363,216,2103465,2104253,912,2105165
311,34,34,2111673,2112222,582,2110275,2111067,591,2111658
312,4,4,2118799,2118849,82,2117084,2117881,903,2118784
313,34,34,2125358,2125908,582,2123910,2124695,648,2125343
314,12,12,2132168,2132351,216,2130719,2131509,643,2132152
315,30,30,2139143,2139626,516,2137528,2138323,805,2139128
316,6,6,2145869,2145953,116,2144354,2145137,717,2145854
317,2,2,2152662,2152679,49,2151164,2151951,696,2152647
318,26,26,2159438,2159854,449,2157973,2158765,658,2159423
319,12,12,2166164,2166347,216,2164782,2165579,570,2166149
320,56,56,2173140,2174055,948,2171608,2172393,732,2173125
321,44,44,2180182,2180898,749,2178417,2179207,960,2180167
322,42,42,2186742,2187424,715,2185227,2186021,706,2186727
323,32,32,2193734,2194250,549,2192036,2192835,884,2193719
324,50,50,2200577,2201392,848,2198862,2199649,913,2200562
325,58,58,2207469,2208418,982,2205671,2206463,991,2207454
326,34,34,2213996,2214545,583,2212480,2213277,703,2213980
327,46,46,2220788,2221537,782,2219306,2220091,682,2220773
328,10,10,2227631,2227781,182,2226116,2226905,711,2227616
329,6,6,2234723,2234806,116,2232925,2233719,989,2234708
330,28,28,2241266,2241715,482,2239734,2240533,718,2241251
331,56,56,2248242,2249157,948,2246560,2247347,880,2248227
332,58,58,2254685,2255634,982,2253369,2254161,508,2254669
333,56,56,2261611,2262526,948,2260179,2260975,621,2261596
334,36,36,2268520,2269102,615,2267005,2267789,716,2268505
335,10,10,2275346,2275496,182,2273814,2274603,728,2275331
336,42,42,2282038,2282721,716,2280623,2281417,606,2282023
337,56,56,2289181,2290096,948,2287433,2288231,935,2289166
338,14,14,2295923,2296140,248,2294259,2295045,864,2295909
339,50,50,2302816,2303632,848,2301068,2301859,942,2302801
340,44,44,2309542,2310258,748,2307877,2308673,854,2309527
341,30,30,2316018,2316501,516,2314703,2315487,516,2316003
342,10,10,2322828,2322977,183,2321512,2322301,511,2322812
343,26,26,2329787,2330203,449,2328322,2329115,657,2329772
344,42,42,2336463,2337145,715,2335131,2335929,519,2336448
345,58,58,2343605,2344554,982,2341957,2342743,847,2343590
346,40,40,2350431,2351080,682,2348766,2349557,859,2350416
347,10,10,2357007,2357157,183,2355575,2356371,621,2356992
348,44,44,2364000,2364715,749,2362401,2363185,799,2363984
349,10,10,2370992,2371142,181,2369211,2369999,979,2370978
350,4,4,2377402,2377452,82,2376020,2376813,574,2377387
351,56,56,2384394,2385310,948,2382829,2383627,752,2384379
352,22,22,2390987,2391337,382,2389655,2390441,531,2390972
353,4,4,2398063,2398113,83,2396464,2397255,792,2398047
354,28,28,2404922,2405371,482,2403274,2404069,838,2404907
355,40,40,2411431,2412081,681,2410100,2410883,534,2411417
356,8,8,2418324,2418441,149,2416909,2417697,612,2418309
357,6,6,2425366,2425450,116,2423718,2424511,840,2425351
358,54,54,2432292,2433175,915,2430527,2431325,952,2432277
359,32,32,2438702,2439218,550,2437353,2438139,547,2438686
360,34,34,2445528,2446077,582,2444163,2444953,560,2445513
361,24,24,2452620,2453003,416,2450972,2451767,838,2452605
362,56,56,2459330,2460245,948,2457798,2458581,734,2459315
363,30,30,2466289,2466772,515,2464607,2465395,879,2466274
364,48,48,2473098,2473880,815,2471416,2472209,874,2473083
365,50,50,2479741,2480557,848,2478226,2479023,703,2479726
366,28,28,2486700,2487149,482,2485052,2485837,848,2486685
367,18,18,2493459,2493742,316,2491861,2492651,793,2493444
368,6,6,2500169,2500252,117,2498670,2499465,688,2500153
369,22,22,2507194,2507544,383,2505496,2506279,900,2507179
370,32,32,2513854,2514370,550,2512305,2513093,745,2513838
371,38,38,2520746,2521362,648,2519115,2519907,825,2520732
372,28,28,2527722,2528172,482,2525924,2526721,986,2527707
373,6,6,2534115,2534198,116,2532750,2533535,565,2534100
374,24,24,2541207,2541590,416,2539559,2540349,843,2541192
375,16,16,2547850,2548100,282,2546369,2547163,673,2547836
376,8,8,2554626,2554743,149,2553194,2553977,634,2554611
377,22,22,2561619,2561968,382,2560004,2560791,813,2561604
378,34,34,2568495,2569044,582,2566813,2567605,875,2568480
379,56,56,2574971,2575887,949,2573622,2574419,536,2574955
380,54,54,2582113,2582996,915,2580448,2581233,865,2582098
381,4,4,2588573,2588623,82,2587258,2588047,511,2588558
382,16,16,2595815,2596065,282,2594067,2594861,939,2595800
383,8,8,2602275,2602391,150,2600876,2601675,584,2602259
384,14,14,2609400,2609617,249,2607702,2608489,896,2609385
385,2,2,2616210,2616226,50,2614511,2615303,891,2616194
386,4,4,2622752,2622802,82,2621321,2622117,621,2622738
387,56,56,2629795,2630710,948,2628147,2628931,849,2629780
388,12,12,2636571,2636754,216,2634956,2635745,811,2636556
389,46,46,2643114,2643863,783,2641765,2642559,539,2643098
390,58,58,2649906,2650855,982,2648574,2649373,518,2649891
391,20,20,2656716,2657032,350,2655400,2656187,513,2656700
392,46,46,2663974,2664724,781,2662210,2663001,959,2663960
393,30,30,2670634,2671117,515,2669019,2669815,804,2670619
394,10,10,2677643,2677793,182,2675845,2676629,999,2677628
395,34,34,2684169,2684719,582,2682654,2683443,711,2684154
396,46,46,2690845,2691594,782,2689463,2690257,573,2690830
397,46,46,2697688,2698437,782,2696273,2697071,602,2697673
398,16,16,2704580,2704830,282,2703099,2703885,681,2704566
399,58,58,2711306,2712255,982,2709908,2710699,592,2711291
400,20,20,2718316,2718632,349,2716717,2717513,787,2718300
401,8,8,2725175,2725291,149,2723543,2724327,833,2725160
402,10,10,2731801,2731951,183,2730352,2731141,644,2731785
403,54,54,2738560,2739443,915,2737162,2737955,590,2738545
404,4,4,2745769,2745819,83,2743971,2744769,985,2745754
405,22,22,2752578,2752928,382,2750797,2751583,981,2752564
406,40,40,2759205,2759854,682,2757606,2758397,792,2759189
407,42,42,2765747,2766430,715,2764416,2765211,522,2765733
408,22,22,2772806,2773156,383,2771241,2772025,766,2772791
409,36,36,2779632,2780215,615,2778051,2778839,779,2779618
410,24,24,2786175,2786558,416,2784860,2785653,507,2786160
411,58,58,2793301,2794250,982,2791669,2792467,819,2793286
412,4,4,2800044,2800094,83,2798495,2799281,747,2800028
413,10,10,2807086,2807236,181,2805305,2806095,977,2807072
414,26,26,2813912,2814328,449,2812114,2812909,988,2813897
415,2,2,2820688,2820705,49,2818940,2819723,950,2820673
416,36,36,2827297,2827880,616,2825749,2826537,745,2827282
417,22,22,2834356,2834706,383,2832558,2833351,990,2834341
418,14,14,2840167,2840383,250,2839368,2839382,769,2840151
419,26,26,2847109,2847525,449,2845411,2846196,898,2847094
420,10,10,2853619,2853769,183,2852220,2853010,593,2853603
421,40,40,2860428,2861077,682,2859030,2859824,589,2860413
422,18,18,2867604,2867887,315,2865856,2866638,951,2867589
423,20,20,2874430,2874746,349,2872665,2873452,963,2874415
424,10,10,2881206,2881355,182,2879474,2880266,925,2881191
425,4,4,2888065,2888115,82,2886283,2887080,970,2888050
426,6,6,2894857,2894941,116,2893109,2893894,948,2894842
427,20,20,2901650,2901966,348,2899919,2900708,928,2901636
428,48,48,2908210,2908992,815,2906728,2907522,673,2908195
429,24,24,2914986,2915369,416,2913537,2914336,634,2914970
430,34,34,2922161,2922711,582,2920363,2921150,996,2922146
431,2,2,2928787,2928804,50,2927172,2927964,808,2928772
432,40,40,2935697,2936346,682,2933982,2934778,904,2935682
433,52,52,2942439,2943288,881,2940808,2941592,833,2942425
434,40,40,2948999,2949648,682,2947617,2948406,578,2948984
435,28,28,2956058,2956507,482,2954426,2955220,823,2956043
436,26,26,2962751,2963167,448,2961236,2962034,702,2962736
437,2,2,2969477,2969493,50,2968061,2968848,613,2969461
438,6,6,2976619,2976702,116,2974871,2975662,942,2976604
439,4,4,2983062,2983112,82,2981680,2982476,571,2983047
440,42,42,2990071,2990754,715,2988506,2989290,766,2990056
441,48,48,2996930,2997713,815,2995315,2996104,811,2996915
442,14,14,3003606,3003823,248,3002125,3002918,674,3003592
443,52,52,3010615,3011464,881,3008934,3009732,869,3010601
444,14,14,3017258,3017475,249,3015760,3016546,697,3017243
445,48,48,3024217,3025000,815,3022569,3023360,842,3024202
446,50,50,3030694,3031509,849,3029378,3030174,504,3030678
447,56,56,3037836,3038752,948,3036204,3036988,833,3037821
448,46,46,3044445,3045195,781,3043014,3043802,629,3044431
449,48,48,3051205,3051987,815,3049823,3050616,574,3051190
450,18,18,3058347,3058630,316,3056632,3057430,902,3058332
451,50,50,3064940,3065756,848,3063458,3064244,681,3064925
452,12,12,3071583,3071766,216,3070267,3071058,509,3071567
453,28,28,3078542,3078991,482,3077077,3077872,655,3078527
454,36,36,3085434,3086017,615,3083903,3084686,734,3085420
455,48,48,3092327,3093109,815,3090712,3091500,812,3092312
456,50,50,3098836,3099652,849,3097521,3098314,507,3098821
457,48,48,3106012,3106794,815,3104330,3105128,869,3105997
458,32,32,3112705,3113221,549,3111156,3111942,747,3112689
459,20,20,3119431,3119747,349,3117966,3118756,660,3119416
460,22,22,3126257,3126606,382,3124775,3125570,672,3126242
461,52,52,3133199,3134048,882,3131601,3132384,800,3133184
462,20,20,3140208,3140525,349,3138410,3139198,995,3140193
463,22,22,3146718,3147067,383,3145219,3146012,690,3146702
464,8,8,3153644,3153760,149,3152029,3152826,803,3153629
465,36,36,3159804,3160386,616,3158855,3158857,931,3159788
466,26,26,3166197,3166613,450,3164881,3165671,510,3166181
467,52,52,3173073,3173922,881,3171691,3172485,573,3173058
468,60,60,3180098,3181081,1015,3178500,3179299,784,3180083
469,54,54,3187041,3187923,915,3185326,3186113,913,3187026
470,54,54,3193600,3194483,915,3192135,3192927,658,3193585
471,48,48,3200693,3201475,815,3198945,3199741,937,3200678
472,50,50,3207335,3208151,849,3205770,3206555,765,3207320
473,52,52,3214361,3215210,881,3212580,3213369,978,3214347
474,50,50,3220771,3221587,848,3219389,3220183,573,3220756
475,46,46,3227597,3228346,783,3226198,3226997,584,3227581
476,24,24,3234406,3234789,416,3233024,3233811,580,3234391
477,46,46,3241448,3242198,781,3239834,3240625,809,3241434
478,14,14,3248125,3248341,249,3246643,3247439,671,3248110
479,34,34,3254851,3255400,582,3253469,3254253,583,3254836
480,54,54,3261976,3262859,915,3260278,3261067,894,3261961
481,28,28,3268586,3269035,483,3267087,3267881,689,3268570
482,32,32,3275345,3275861,549,3273897,3274695,635,3275330
483,12,12,3282121,3282304,216,3280723,3281509,597,3282106
484,8,8,3289247,3289363,149,3287532,3288323,909,3289232
485,56,56,3295939,3296855,949,3294341,3295137,787,3295924
486,16,16,3302665,3302915,283,3301167,3301951,699,3302650
487,58,58,3309675,3310623,982,3307976,3308765,894,3309659
488,52,52,3316334,3317183,882,3314786,3315579,740,3316319
489,56,56,3323376,3324292,948,3321595,3322393,969,3323362
490,30,30,3329753,3330236,515,3328421,3329207,531,3329738
491,34,34,3337012,3337561,582,3335230,3336021,976,3336997
492,18,18,3343688,3343971,316,3342039,3342835,837,3343672
493,46,46,3350564,3351313,782,3348865,3349649,899,3350548
494,20,20,3357389,3357706,348,3355675,3356463,912,3357375
495,54,54,3364232,3365114,915,3362484,3363277,940,3364217
496,10,10,3370958,3371108,183,3369293,3370091,852,3370943
497,16,16,3377684,3377934,283,3376119,3376905,764,3377669
498,32,32,3384443,3384960,549,3382928,3383719,709,3384428
499,52,52,3391269,3392118,881,3389738,3390533,722,3391255
500,44,44,3397929,3398645,748,3396564,3397347,567,3397914
501,38,38,3405088,3405704,648,3403373,3404161,912,3405073
502,50,50,3411780,3412596,849,3410182,3410975,790,3411765
503,14,14,3418457,3418673,249,3416992,3417789,653,3418442
504,42,42,3425582,3426265,715,3423817,3424603,964,3425567
505,46,46,3432208,3432958,781,3430627,3431417,777,3432194
506,52,52,3438751,3439600,882,3437436,3438231,505,3438736
507,22,22,3446043,3446393,382,3444262,3445045,984,3446029
508,10,10,3452719,3452869,183,3451071,3451859,845,3452704
509,14,14,3459562,3459778,248,3457881,3458673,875,3459548
510,28,28,3466305,3466754,482,3464690,3465487,803,3466290
511,40,40,3473147,3473797,681,3471516,3472301,832,3473133
512,30,30,3480106,3480589,515,3478325,3479115,977,3480092
513,52,52,3486766,3487615,882,3485134,3485929,822,3486751
514,36,36,3493708,3494291,616,3491960,3492743,950,3493693
515,22,22,3500318,3500667,382,3498770,3499557,746,3500303
516,40,40,3507310,3507960,681,3505579,3506371,925,3507296
517,26,26,3514186,3514602,449,3512388,3513185,986,3514171
518,36,36,3520979,3521561,615,3519214,3519999,965,3520964
519,14,14,3527488,3527705,250,3526023,3526813,660,3527473
520,12,12,3534514,3534697,215,3532833,3533627,873,3534500
521,24,24,3541074,3541457,415,3539659,3540441,618,3541059
522,16,16,3547850,3548099,282,3546468,3547255,580,3547835
523,36,36,3554992,3555575,615,3553277,3554069,908,3554977
524,32,32,3561868,3562384,549,3560086,3560883,970,3561853
525,32,32,3568577,3569093,549,3566912,3567697,865,3568562
526,46,46,3575187,3575936,782,3573722,3574511,661,3575172
527,8,8,3581863,3581979,149,3580531,3581325,523,3581848
528,20,20,3589005,3589321,349,3587340,3588139,851,3588990
529,48,48,3595898,3596680,815,3594166,3594953,930,3595883
530,2,2,3602574,3602590,50,3600975,3601767,791,3602558
531,18,18,3609100,3609383,316,3607785,3608581,504,3609085
532,28,28,3616176,3616625,482,3614611,3615395,766,3616161
533,20,20,3622935,3623251,349,3621420,3622209,711,3622920
534,12,12,3629694,3629877,216,3628229,3629023,656,3629679
535,40,40,3636720,3637369,682,3635038,3635837,868,3636705
536,20,20,3643529,3643846,349,3641864,3642651,863,3643514
537,24,24,3650205,3650588,415,3648674,3649465,726,3650191
538,16,16,3657015,3657264,282,3655483,3656279,721,3657000
539,14,14,3663841,3664057,249,3662309,3663093,733,3663826
540,8,8,3670816,3670933,150,3669118,3669907,894,3670801
541,54,54,3677459,3678342,914,3675928,3676721,724,3677445
542,38,38,3684169,3684785,648,3682737,3683535,619,3684154
543,18,18,3691211,3691494,316,3689563,3690349,847,3691196
544,20,20,3697804,3698120,349,3696372,3697163,626,3697789
545,6,6,3704796,3704879,116,3703181,3703977,804,3704781
546,54,54,3711755,3712638,915,3710007,3710791,949,3711740
547,2,2,3718182,3718198,49,3716817,3717605,562,3718167
548,12,12,3725074,3725257,216,3723626,3724419,640,3725059
549,42,42,3731900,3732583,715,3730435,3731233,652,3731885
550,12,12,3738576,3738759,216,3737261,3738047,514,3738561
551,36,36,3745469,3746051,616,3744070,3744861,592,3745453
552,38,38,3752328,3752944,649,3750880,3751675,638,3752313
553,26,26,3759304,3759720,449,3757706,3758489,800,3759289
554,42,42,3765880,3766563,715,3764515,3765303,562,3765865
555,32,32,3772739,3773255,549,3771324,3772117,607,3772724
556,30,30,3779865,3780348,515,3778133,3778931,919,3779850
557,34,34,3786474,3787024,582,3784959,3785745,714,3786459
558,38,38,3793517,3794133,648,3791769,3792559,943,3793502
559,44,44,3800376,3801092,748,3798578,3799373,988,3800361
560,24,24,3806719,3807102,416,3805404,3806187,517,3806704
561,12,12,3813861,3814044,216,3812213,3813001,845,3813846
562,38,38,3820770,3821386,649,3819022,3819815,940,3820755
563,38,38,3827447,3828063,648,3825832,3826629,803,3827432
564,8,8,3834206,3834322,149,3832658,3833443,748,3834191
565,2,2,3841215,3841232,49,3839467,3840257,943,3841200
566,20,20,3847625,3847941,350,3846276,3847071,538,3847609
567,8,8,3854417,3854534,150,3853102,3853885,517,3854402
568,20,20,3861610,3861926,350,3859911,3860699,895,3861594
569,14,14,3868036,3868252,249,3866721,3867513,508,3868021
570,22,22,3875311,3875661,382,3873530,3874327,970,3875297
571,22,22,3881904,3882254,383,3880356,3881141,748,3881889
572,10,10,3888597,3888747,182,3887165,3887955,627,3888582
573,44,44,3895390,3896106,749,3893974,3894769,605,3895374
574,6,6,3902282,3902365,116,3900800,3901583,684,3902267
575,50,50,3909225,3910040,848,3907610,3908397,813,3909210
576,20,20,3915901,3916217,349,3914419,3915211,675,3915886
577,34,34,3922544,3923093,583,3921228,3922025,503,3922528
578,22,22,3929453,3929802,383,3928054,3928839,598,3929437
579,34,34,3936245,3936795,582,3934863,3935653,577,3936230
580,12,12,3943404,3943587,215,3941673,3942467,923,3943390
581,50,50,3950014,3950830,848,3948482,3949281,718,3949999
582,18,18,3956906,3957189,316,3955308,3956095,796,3956891
583,18,18,3963449,3963732,316,3962117,3962909,525,3963434
584,32,32,3970425,3970941,549,3968927,3969723,687,3970410
585,28,28,3977284,3977734,481,3975753,3976537,733,3977270
586,50,50,3984110,3984926,849,3982562,3983351,744,3984095
587,36,36,3990969,3991552,616,3989371,3990165,789,3990954
588,6,6,3997962,3998045,116,3996180,3996979,968,3997947
589,34,34,4004621,4005171,582,4003006,4003793,813,4004606
590,44,44,4011214,4011930,749,4009816,4010607,592,4011199
591,8,8,4018123,4018240,149,4016625,4017421,687,4018108
592,6,6,4024883,4024966,115,4023451,4024235,633,4024868
593,20,20,4031642,4031958,349,4030260,4031049,578,4031627
594,60,60,4038734,4039717,1015,4037069,4037863,856,4038719
595,42,42,4045627,4046309,715,4043879,4044677,935,4045612
596,38,38,4052336,4052952,648,4050705,4051491,831,4052322
597,38,38,4058912,4059528,649,4057514,4058305,592,4058897
598,38,38,4066005,4066621,648,4064323,4065119,871,4065990
599,12,12,4072564,4072747,216,4071149,4071933,616,4072549
600,24,24,4079374,4079756,416,4077958,4078747,611,4079358
601,44,44,4086083,4086799,748,4084768,4085561,507,4086068
602,40,40,4093092,4093741,682,4091577,4092375,702,4093077
603,22,22,4100168,4100517,382,4098403,4099189,964,4100153
604,14,14,4106794,4107010,249,4105212,4106003,776,4106779
605,42,42,4113370,4114053,716,4112021,4112817,537,4113354
606,58,58,4120379,4121328,982,4118847,4119631,733,4120364
607,52,52,4127188,4128037,881,4125657,4126445,729,4127174
608,8,8,4133831,4133948,149,4132466,4133259,557,4133816
609,58,58,4140907,4141856,981,4139275,4140073,819,4140892
610,58,58,4147783,4148732,981,4146101,4146887,881,4147768
611,12,12,4154242,4154425,216,4152910,4153701,526,4154227
612,22,22,4161501,4161851,381,4159720,4160515,972,4161487
613,8,8,4168261,4168377,149,4166546,4167329,917,4168246
614,52,52,4175103,4175952,882,4173355,4174143,945,4175088
615,32,32,4181529,4182046,549,4180164,4180957,557,4181514
616,4,4,4188672,4188722,82,4186974,4187771,886,4188657
617,20,20,4195531,4195847,349,4193799,4194585,931,4195516
618,8,8,4202207,4202324,149,4200609,4201399,793,4202192
619,18,18,4208933,4209216,316,4207418,4208213,705,4208918
620,8,8,4215759,4215876,149,4214244,4215027,717,4215744
621,20,20,4222352,4222668,350,4221053,4221841,495,4222336
622,38,38,4229594,4230210,648,4227863,4228655,925,4229580
623,42,42,4236087,4236770,715,4234672,4235469,603,4236072
624,60,60,4243129,4244112,1014,4241498,4242283,832,4243115
625,18,18,4249872,4250155,316,4248307,4249097,760,4249857
626,54,54,4256881,4257763,915,4255116,4255911,955,4256866
627,48,48,4263707,4264490,815,4261942,4262725,967,4263692
628,56,56,4270100,4271016,948,4268752,4269539,546,4270085
629,4,4,4277326,4277376,82,4275561,4276353,958,4277311
630,8,8,4283735,4283852,150,4282370,4283167,553,4283720
631,46,46,4290661,4291410,782,4289196,4289981,665,4290646
632,60,60,4297387,4298369,1015,4296005,4296795,577,4297372
633,36,36,4304513,4305096,615,4302815,4303609,889,4304498
634,46,46,4311106,4311855,782,4309641,4310423,668,4311091
635,44,44,4318098,4318814,749,4316450,4317237,846,4318083
636,8,8,4324991,4325107,149,4323259,4324051,925,4324976
637,14,14,4331484,4331700,250,4330068,4330865,603,4331468
638,28,28,4338543,4338992,483,4336894,4337679,848,4338527
639,14,14,4345069,4345285,249,4343704,4344493,561,4345054
640,18,18,4352128,4352411,316,4350513,4351307,806,4352113
641,10,10,4359087,4359237,182,4357322,4358121,951,4359072
642,10,10,4365730,4365880,182,4364148,4364935,780,4365715
643,8,8,4372572,4372689,150,4370957,4371749,808,4372557
644,38,38,4379382,4379998,648,4377767,4378563,804,4379367
645,32,32,4385958,4386474,549,4384593,4385377,566,4385943
646,56,56,4393017,4393933,948,4391402,4392191,811,4393002
647,32,32,4398861,4399377,550,4398211,4398222,622,4398844
648,56,56,4405753,4406669,948,4404238,4405036,702,4405738
649,14,14,4412762,4412979,249,4411064,4411850,897,4412747
650,52,52,4419189,4420038,882,4417873,4418664,509,4419173
651,40,40,4426331,4426980,682,4424683,4425478,838,4426316
652,52,52,4432840,4433689,882,4431508,4432292,533,4432825
