TRL_TRIAL_NUMBER,TRL_USE_SSD_VR_COUNT,TRL_SSD_VR_COUNT,TRL_TARG_ON_TIME,TRL_STOP_SIGNAL_TIME,TRL_STOP_SIGNAL_DURATION,TRL_FIX_ON_TIME,TRL_FIX_ACQ_TIME,TRL_FIX_HOLD,TRL_FIXATED_TIME
1,6,6,2388,2471,100,1073,1859,523,2382
2,18,18,9181,9464,300,7882,8673,501,9174
3,18,18,15541,15824,299,14692,14704,830,15534
4,32,32,22383,22899,533,20735,21518,859,22377
5,42,42,29026,29709,699,27544,28332,687,29019
6,20,20,36118,36435,333,34354,35146,967,36113
7,56,56,42928,43843,932,41163,41960,962,42922
8,2,2,49537,49554,33,47989,48774,757,49531
9,14,14,56563,56779,233,54798,55588,969,56557
10,26,26,63239,63655,433,61607,62402,830,63232
11,26,26,69815,70231,433,68433,69216,592,69808
12,58,58,76541,77490,966,75243,76030,505,76535
13,6,6,83733,83817,100,82052,82844,883,83727
14,18,18,90343,90626,300,88861,89658,678,90336
15,24,24,97019,97402,400,95687,96472,540,97012
16,40,40,103878,104528,666,102496,103286,585,103871
17,54,54,110987,111870,899,109306,110100,881,110981
18,42,42,117846,118529,700,116115,116914,926,117840
19,36,36,124339,124922,600,122941,123728,605,124333
20,38,38,131049,131665,632,129750,130542,500,131042
21,50,50,138308,139123,832,136559,137356,945,138301
22,56,56,145034,145949,932,143385,144170,857,145027
23,44,44,151876,152592,733,150195,150984,886,151870
24,44,44,158752,159468,733,157004,157798,948,158746
25,34,34,165412,165961,566,163813,164612,793,165405
26,60,60,172354,173336,999,170639,171426,922,172348
27,22,22,178930,179280,367,177448,178240,683,178923
28,22,22,185723,186072,366,184258,185054,663,185717
29,22,22,192515,192865,367,191084,191868,641,192509
30,26,26,199674,200091,433,197893,198682,986,199668
31,34,34,206417,206966,566,204702,205496,915,206411
32,48,48,212943,213726,800,211512,212310,627,212937
33,30,30,219886,220369,499,218338,219124,756,219880
34,58,58,226928,227877,966,225147,225938,984,226922
35,2,2,233305,233321,33,231956,232752,546,233298
36,44,44,240347,241063,733,238782,239566,775,240341
37,36,36,246940,247523,599,245591,246380,553,246933
38,50,50,254049,254865,832,252401,253194,849,254043
39,6,6,261008,261091,100,259210,260008,994,261002
40,54,54,267634,268516,899,266036,266822,806,267628
41,6,6,274177,274260,100,272845,273636,534,274170
42,44,44,281369,282085,733,279654,280450,913,281363
43,56,56,288129,289044,932,286480,287264,858,288122
44,50,50,294871,295687,833,293290,294078,787,294865
45,50,50,301431,302247,832,300099,300892,532,301424
46,30,30,308590,309072,499,306908,307706,877,308583
47,40,40,315066,315715,666,313734,314520,539,315059
48,16,16,322258,322508,267,320543,321334,918,322252
49,16,16,329101,329350,266,327353,328148,947,329095
50,52,52,335794,336643,865,334179,334962,826,335788
51,6,6,342520,342603,99,340988,341776,737,342513
52,20,20,349179,349495,333,347797,348590,582,349172
53,6,6,355972,356055,100,354606,355404,561,355965
54,32,32,362897,363414,533,361432,362218,673,362891
55,16,16,369956,370206,267,368242,369032,919,369951
56,10,10,376516,376666,167,375051,375846,664,376510
57,32,32,383508,384025,533,381877,382660,842,383502
58,6,6,390101,390185,100,388686,389474,621,390095
59,10,10,397160,397310,167,395495,396288,866,397154
60,32,32,403770,404286,533,402305,403102,662,403764
61,30,30,410679,411162,499,409131,409916,757,410673
62,58,58,417472,418421,965,415940,416730,735,417465
63,10,10,424198,424348,166,422749,423544,647,424191
64,30,30,431007,431490,499,429575,430358,642,431000
65,24,24,437999,438382,400,436384,437172,821,437993
66,4,4,444775,444825,67,443194,443986,783,444769
67,40,40,451718,452367,666,450003,450800,912,451712
68,48,48,458144,458927,799,456829,457614,524,458138
69,10,10,465320,465470,166,463638,464428,885,465313
70,32,32,471863,472379,532,470448,471242,615,471857
71,20,20,478639,478955,333,477273,478056,576,478632
72,56,56,485631,486547,932,484083,484870,755,485625
73,38,38,492207,492823,633,490892,491684,517,492201
74,56,56,499033,499949,933,497701,498498,528,499026
75,32,32,506026,506542,532,504527,505312,707,506019
76,2,2,513018,513035,33,511337,512126,886,513012
77,54,54,519777,520660,899,518146,518940,831,519771
78,36,36,526420,527003,600,524955,525754,660,526414
79,22,22,533379,533729,367,531781,532568,805,533373
80,60,60,540055,541038,999,538590,539382,667,540049
81,58,58,547098,548047,965,545400,546196,896,547092
82,2,2,553741,553757,33,552226,553010,725,553735
83,48,48,560816,561599,799,559035,559824,986,560810
84,54,54,567426,568308,899,565844,566638,781,567419
85,20,20,574418,574735,333,572653,573452,960,574412
86,54,54,580878,581760,899,579479,580266,605,580871
87,16,16,587887,588137,266,586289,587080,801,587881
88,42,42,594397,595079,699,593098,593894,496,594390
89,52,52,601439,602288,866,599924,600708,725,601433
90,18,18,608265,608548,300,606733,607522,736,608258
91,50,50,615274,616090,832,613542,614336,931,615267
92,18,18,622067,622350,299,620352,621150,911,622061
93,16,16,628892,629142,267,627178,627964,923,628887
94,14,14,635668,635885,234,633987,634778,884,635662
95,56,56,642145,643060,932,640796,641592,546,642138
96,56,56,649337,650253,932,647622,648406,925,649331
97,36,36,655763,656346,600,654431,655220,536,655756
98,20,20,662922,663239,333,661241,662034,882,662916
99,38,38,669798,670414,633,668050,668848,944,669792
100,6,6,676291,676374,100,674876,675662,623,676285
101,18,18,683467,683750,299,681685,682476,984,683460
102,42,42,690076,690759,699,688495,689290,780,690070
103,54,54,696985,697868,899,695320,696104,875,696979
104,16,16,703828,704078,266,702130,702918,904,703822
105,12,12,710637,710820,200,708939,709732,899,710631
106,8,8,717380,717496,133,715748,716546,827,717373
107,48,48,724222,725005,800,722574,723360,856,724216
108,44,44,730815,731531,733,729384,730174,635,730809
109,22,22,737891,738241,366,736193,736988,897,737885
110,32,32,744667,745183,533,743019,743802,859,744661
111,8,8,751526,751643,133,749828,750616,904,751520
112,28,28,758385,758835,467,756637,757430,949,758379
113,56,56,764745,765661,933,763447,764244,495,764739
114,16,16,771571,771821,267,770273,771058,507,771565
115,24,24,778514,778897,399,777082,777872,635,778507
116,22,22,785423,785772,366,783891,784686,730,785416
117,6,6,792382,792465,100,790717,791500,876,792376
118,18,18,798858,799141,300,797526,798314,537,798851
119,38,38,805801,806417,632,804336,805128,667,805795
120,24,24,812627,813010,399,811145,811942,678,812620
121,22,22,819669,820019,366,817971,818756,907,819663
122,42,42,826279,826961,699,824780,825570,702,826272
123,48,48,833038,833820,799,831589,832384,647,833031
124,16,16,839930,840180,267,838415,839198,726,839924
125,14,14,846656,846873,234,845225,846012,638,846650
126,32,32,853715,854232,533,852034,852826,883,853709
127,54,54,860475,861357,899,858843,859640,828,860468
128,4,4,867234,867284,67,865669,866454,774,867228
129,48,48,874043,874826,800,872478,873268,769,874037
130,40,40,880936,881585,666,879288,880082,848,880930
131,20,20,887479,887795,333,886097,886896,576,887472
132,54,54,894255,895137,899,892923,893710,538,894248
133,30,30,901247,901730,500,899732,900524,717,901241
134,34,34,907957,908506,566,906542,907338,613,907951
135,26,26,914666,915082,433,913367,914152,507,914659
136,32,32,921742,922258,532,920177,920966,770,921736
137,10,10,928668,928817,166,926986,927780,881,928661
138,46,46,935310,936060,766,933795,934594,710,935304
139,36,36,942303,942885,599,940621,941408,888,942296
140,36,36,949012,949595,600,947431,948222,784,949006
141,40,40,955738,956387,666,954240,955036,696,955732
142,48,48,962464,963247,799,961066,961850,608,962458
143,50,50,969640,970456,832,967875,968664,970,969634
144,56,56,976199,977115,933,974684,975478,715,976193
145,50,50,982892,983708,833,981494,982292,594,982886
146,42,42,989968,990650,699,988320,989106,856,989962
147,6,6,996461,996544,100,995129,995920,534,996454
148,38,38,1003486,1004102,633,1001938,1002734,746,1003480
149,46,46,1010262,1011012,766,1008764,1009548,708,1010256
150,14,14,1017188,1017405,233,1015573,1016362,820,1017182
151,42,42,1024164,1024847,699,1022383,1023176,982,1024158
152,54,54,1030674,1031556,899,1029192,1029990,677,1030667
153,14,14,1037350,1037566,233,1036018,1036804,539,1037343
154,60,60,1044492,1045474,999,1042827,1043618,868,1044486
155,60,60,1051201,1052184,999,1049636,1050432,763,1051195
156,26,26,1058044,1058460,433,1056462,1057246,791,1058037
157,32,32,1064936,1065453,533,1063272,1064060,871,1064931
158,46,46,1071563,1072312,765,1070081,1070874,682,1071556
159,48,48,1078305,1079088,799,1076890,1077688,611,1078299
160,48,48,1085348,1086130,799,1083716,1084502,839,1085341
161,40,40,1091924,1092573,666,1090525,1091316,601,1091917
162,30,30,1098950,1099432,499,1097335,1098130,814,1098944
163,32,32,1105742,1106258,533,1104161,1104944,792,1105736
164,36,36,1112335,1112918,599,1110970,1111758,571,1112329
165,28,28,1119294,1119744,466,1117779,1118572,716,1119288
166,24,24,1125954,1126337,399,1124588,1125386,561,1125947
167,26,26,1132913,1133329,433,1131414,1132200,706,1132906
168,10,10,1139805,1139955,167,1138224,1139014,785,1139799
169,24,24,1146764,1147147,400,1145033,1145828,930,1146758
170,24,24,1153491,1153873,399,1151859,1152642,842,1153484
171,58,58,1160100,1161049,966,1158668,1159456,637,1160093
172,52,52,1166909,1167758,866,1165478,1166270,633,1166903
173,32,32,1173952,1174468,532,1172287,1173084,862,1173946
174,20,20,1180744,1181061,333,1179113,1179898,840,1180738
175,40,40,1187337,1187986,666,1185922,1186712,619,1187331
176,54,54,1194130,1195012,899,1192731,1193526,597,1194123
177,56,56,1201056,1201971,932,1199557,1200340,709,1201049
178,6,6,1207865,1207948,100,1206367,1207154,705,1207859
179,50,50,1214807,1215623,833,1213176,1213968,833,1214801
180,20,20,1221766,1222083,333,1219985,1220782,978,1221760
181,16,16,1228509,1228759,267,1226811,1227596,907,1228503
182,48,48,1235102,1235885,799,1233620,1234410,685,1235095
183,10,10,1242178,1242328,166,1240430,1241224,948,1242172
184,48,48,1248920,1249703,800,1247256,1248038,877,1248915
185,6,6,1255780,1255863,100,1254065,1254852,922,1255774
186,50,50,1262372,1263188,833,1260874,1261666,700,1262366
187,42,42,1268999,1269681,699,1267683,1268480,512,1268992
188,28,28,1276074,1276524,466,1274509,1275294,774,1276068
189,30,30,1283100,1283583,499,1281319,1282108,986,1283094
190,24,24,1289859,1290242,400,1288128,1288922,931,1289853
191,56,56,1296319,1297235,932,1294937,1295736,576,1296312
192,40,40,1303428,1304077,666,1301763,1302550,872,1303422
193,30,30,1310237,1310720,500,1308572,1309364,867,1310231
194,14,14,1317113,1317330,233,1315382,1316178,929,1317107
195,54,54,1323656,1324538,899,1322208,1322992,658,1323650
196,58,58,1330648,1331597,966,1329017,1329806,836,1330642
197,38,38,1337558,1338174,632,1335826,1336620,931,1337551
198,36,36,1344134,1344717,599,1342635,1343434,693,1344127
199,14,14,1351193,1351409,233,1349461,1350248,938,1351186
200,52,52,1357636,1358485,866,1356271,1357062,568,1357630
201,46,46,1364495,1365244,766,1363080,1363876,613,1364489
202,58,58,1371587,1372536,966,1369906,1370690,891,1371581
203,50,50,1378064,1378880,832,1376715,1377504,553,1378057
204,52,52,1384906,1385755,866,1383524,1384318,581,1384899
205,24,24,1391732,1392115,400,1390334,1391132,594,1391726
206,38,38,1398458,1399074,633,1397160,1397946,506,1398452
207,24,24,1405617,1406000,400,1403969,1404760,851,1405611
208,24,24,1412526,1412909,400,1410778,1411574,946,1412520
209,44,44,1418986,1419702,733,1417604,1418388,591,1418979
210,44,44,1425729,1426445,732,1424414,1425202,521,1425723
211,24,24,1432705,1433087,399,1431223,1432016,682,1432698
212,12,12,1439597,1439780,200,1438032,1438830,761,1439591
213,6,6,1446373,1446456,100,1444858,1445644,723,1446367
214,8,8,1452999,1453116,133,1451667,1452458,534,1452992
215,46,46,1460075,1460824,766,1458477,1459272,797,1460069
216,54,54,1467051,1467933,899,1465303,1466086,959,1467045
217,40,40,1473710,1474359,666,1472112,1472900,804,1473704
218,46,46,1480669,1481418,766,1478921,1479714,949,1480663
219,28,28,1487129,1487578,466,1485730,1486528,594,1487122
220,2,2,1494088,1494105,33,1492556,1493342,739,1494081
221,54,54,1500697,1501580,900,1499366,1500156,535,1500691
222,38,38,1507823,1508439,633,1506175,1506970,847,1507817
223,36,36,1514433,1515015,599,1513001,1513784,642,1514426
224,40,40,1521308,1521958,666,1519810,1520598,704,1521302
225,42,42,1528218,1528900,699,1526619,1527412,799,1528211
226,10,10,1534877,1535027,167,1533429,1534226,645,1534871
227,18,18,1542036,1542319,300,1540255,1541040,990,1542030
228,56,56,1548496,1549411,932,1547064,1547854,635,1548489
229,2,2,1555655,1555671,33,1553873,1554668,980,1555648
230,10,10,1562281,1562431,166,1560699,1561482,792,1562274
231,38,38,1569057,1569673,632,1567508,1568296,754,1569050
232,52,52,1575683,1576532,866,1574318,1575110,567,1575677
233,50,50,1582642,1583458,832,1581127,1581924,712,1582636
234,24,24,1589268,1589651,400,1587953,1588738,524,1589262
235,44,44,1596460,1597176,733,1594762,1595552,902,1596454
236,38,38,1603186,1603802,633,1601571,1602366,814,1603180
237,30,30,1609996,1610478,499,1608397,1609180,809,1609989
238,20,20,1616572,1616888,333,1615207,1615994,572,1616566
239,42,42,1623614,1624297,700,1622016,1622808,800,1623608
240,50,50,1630290,1631106,833,1628825,1629622,662,1630284
241,48,48,1637249,1638032,800,1635651,1636436,807,1637243
242,52,52,1643959,1644808,866,1642460,1643250,702,1643952
243,24,24,1650685,1651068,399,1649270,1650064,615,1650679
244,52,52,1657478,1658327,865,1656079,1656878,593,1657471
245,34,34,1664503,1665053,566,1662905,1663692,805,1664497
246,48,48,1671412,1672195,800,1669714,1670506,900,1671406
247,38,38,1678238,1678854,633,1676524,1677320,913,1678233
248,20,20,1684865,1685181,333,1683349,1684134,724,1684858
249,46,46,1691890,1692639,766,1690159,1690948,936,1691884
250,8,8,1698400,1698516,133,1696968,1697762,631,1698393
251,4,4,1705192,1705242,67,1703777,1704576,610,1705186
252,2,2,1712102,1712118,33,1710603,1711390,705,1712095
253,20,20,1719027,1719344,333,1717413,1718204,818,1719022
254,4,4,1725620,1725670,67,1724222,1725018,596,1725614
255,8,8,1732513,1732629,133,1731048,1731832,675,1732507
256,40,40,1739256,1739905,666,1737857,1738646,603,1739249
257,32,32,1746065,1746581,533,1744666,1745460,598,1746058
258,44,44,1753240,1753956,733,1751476,1752274,961,1753235
259,22,22,1759933,1760283,366,1758302,1759088,839,1759927
260,50,50,1766593,1767408,832,1765111,1765902,684,1766586
261,22,22,1773568,1773918,367,1771920,1772716,846,1773562
262,26,26,1780261,1780677,433,1778746,1779530,725,1780255
263,46,46,1786937,1787686,766,1785555,1786344,586,1786930
264,8,8,1793846,1793963,134,1792365,1793158,682,1793840
265,28,28,1800639,1801089,466,1799174,1799972,661,1800633
266,28,28,1807298,1807748,467,1806000,1806786,506,1807292
267,20,20,1814441,1814757,333,1812809,1813600,834,1814434
268,24,24,1821383,1821766,400,1819618,1820414,963,1821377
269,54,54,1828159,1829042,899,1826444,1827228,925,1828153
270,60,60,1835002,1835984,999,1833254,1834042,954,1834996
271,14,14,1841495,1841711,233,1840063,1840856,632,1841488
272,10,10,1848604,1848754,166,1846872,1847670,927,1848597
273,16,16,1855296,1855546,267,1853698,1854484,806,1855290
274,40,40,1861939,1862589,666,1860507,1861298,634,1861932
275,36,36,1868715,1869298,600,1867317,1868112,597,1868709
276,24,24,1875508,1875891,399,1874143,1874926,576,1875502
277,26,26,1882384,1882800,433,1880952,1881740,637,1882377
278,2,2,1889326,1889343,34,1887761,1888554,766,1889320
279,44,44,1896069,1896785,732,1894571,1895368,695,1896063
280,14,14,1902795,1903011,233,1901396,1902182,606,1902788
281,20,20,1909754,1910070,333,1908206,1908996,752,1909748
282,18,18,1916480,1916763,300,1915015,1915810,664,1916474
283,60,60,1923239,1924222,999,1921841,1922624,609,1923233
284,10,10,1930265,1930415,167,1928650,1929438,821,1930259
285,6,6,1937174,1937258,100,1935460,1936252,917,1937169
286,42,42,1943817,1944500,699,1942269,1943066,745,1943811
287,2,2,1950793,1950810,33,1949095,1949880,907,1950787
288,16,16,1957219,1957469,267,1955904,1956694,519,1957213
289,52,52,1964328,1965177,866,1962713,1963508,814,1964322
290,58,58,1970921,1971870,966,1969539,1970322,592,1970914
291,44,44,1977631,1978346,732,1976349,1977136,488,1977624
292,2,2,1984606,1984623,34,1983158,1983950,650,1984600
293,16,16,1991399,1991649,266,1989967,1990764,628,1991392
294,44,44,1998092,1998808,732,1996793,1997578,507,1998085
295,36,36,2005167,2005750,600,2003602,2004392,769,2005161
296,48,48,2012143,2012926,799,2010412,2011206,931,2012137
297,26,26,2018769,2019185,433,2017238,2018020,743,2018763
298,40,40,2025529,2026178,666,2024047,2024834,688,2025522
299,24,24,2032238,2032621,400,2030856,2031648,583,2032231
300,38,38,2039414,2040030,632,2037665,2038462,945,2039407
301,34,34,2046206,2046756,566,2044491,2045276,924,2046200
302,40,40,2053049,2053698,666,2051301,2052090,953,2053043
303,58,58,2059791,2060740,966,2058110,2058904,881,2059785
304,34,34,2066351,2066900,566,2064919,2065718,626,2066344
305,30,30,2073477,2073959,499,2071745,2072532,938,2073470
306,2,2,2080036,2080053,33,2078554,2079346,683,2080029
307,56,56,2086712,2087628,933,2085364,2086160,546,2086706
308,42,42,2093821,2094504,699,2092190,2092974,841,2093815
309,26,26,2100497,2100914,433,2098999,2099788,703,2100491
310,40,40,2107223,2107873,666,2105808,2106602,615,2107217
311,26,26,2114332,2114749,433,2112618,2113416,911,2114327
312,14,14,2121225,2121441,233,2119443,2120230,988,2121218
313,52,52,2128017,2128867,866,2126253,2127044,968,2128012
314,8,8,2134444,2134560,133,2133062,2133858,579,2134437
315,56,56,2141236,2142152,933,2139888,2140672,558,2141230
316,54,54,2148296,2149178,899,2146697,2147486,803,2148289
317,30,30,2155238,2155721,499,2153507,2154300,932,2155232
318,34,34,2161997,2162547,566,2160316,2161114,877,2161991
319,58,58,2168773,2169722,966,2167142,2167928,839,2168767
320,6,6,2175682,2175766,100,2173951,2174742,934,2175676
321,14,14,2182458,2182675,234,2180760,2181556,896,2182452
322,54,54,2189301,2190183,899,2187586,2188370,925,2189295
323,36,36,2195977,2196560,600,2194396,2195184,787,2195971
324,26,26,2202936,2203352,433,2201205,2201998,932,2202930
325,60,60,2209662,2210645,999,2208014,2208812,844,2209656
326,10,10,2216555,2216705,166,2214840,2215626,923,2216549
327,40,40,2223347,2223997,666,2221649,2222440,901,2223341
328,42,42,2229840,2230523,700,2228459,2229254,580,2229834
329,4,4,2236850,2236899,66,2235285,2236068,776,2236844
330,38,38,2243592,2244208,633,2242094,2242882,704,2243586
331,44,44,2250668,2251384,732,2248903,2249696,966,2250662
332,48,48,2257261,2258043,799,2255712,2256510,744,2257254
333,58,58,2264320,2265269,965,2262538,2263324,989,2264313
334,2,2,2270979,2270996,34,2269348,2270138,835,2270973
335,8,8,2277456,2277572,133,2276157,2276952,497,2277449
336,22,22,2284465,2284814,366,2282983,2283766,692,2284458
337,48,48,2291107,2291890,800,2289792,2290580,521,2291101
338,46,46,2298266,2299015,766,2296601,2297394,866,2298260
339,50,50,2304743,2305558,832,2303411,2304208,528,2304736
340,10,10,2311835,2311985,166,2310237,2311022,807,2311829
341,8,8,2318528,2318644,133,2317046,2317836,685,2318521
342,8,8,2325254,2325370,133,2323855,2324650,597,2325247
343,56,56,2332046,2332962,933,2330681,2331464,576,2332040
344,40,40,2338872,2339522,666,2337490,2338278,587,2338865
345,56,56,2345865,2346780,932,2344300,2345092,767,2345859
346,16,16,2352657,2352907,267,2351109,2351906,745,2352651
347,30,30,2359417,2359899,499,2357935,2358720,690,2359410
348,42,42,2366093,2366775,699,2364744,2365534,552,2366086
349,36,36,2373069,2373651,599,2371554,2372348,715,2373063
350,14,14,2379928,2380144,233,2378379,2379162,759,2379921
351,44,44,2386637,2387353,733,2385189,2385976,655,2386631
352,8,8,2393663,2393779,133,2391998,2392790,867,2393657
353,36,36,2400505,2401088,600,2398807,2399604,895,2400499
354,22,22,2407365,2407714,366,2405633,2406418,940,2407358
355,4,4,2413808,2413858,66,2412443,2413232,570,2413802
356,44,44,2420634,2421350,732,2419252,2420046,581,2420627
357,2,2,2427693,2427709,33,2426061,2426860,826,2427686
358,34,34,2434519,2435068,566,2432887,2433674,838,2434512
359,24,24,2441444,2441827,400,2439696,2440488,950,2441438
360,42,42,2448054,2448737,699,2446506,2447302,746,2448048
361,52,52,2454697,2455546,865,2453332,2454116,575,2454691
362,30,30,2461889,2462372,499,2460141,2460930,953,2461883
363,26,26,2468299,2468715,433,2466950,2467744,548,2468292
364,34,34,2475374,2475924,566,2473759,2474558,810,2475368
365,58,58,2482167,2483116,966,2480585,2481372,788,2482160
366,60,60,2488776,2489759,999,2487395,2488186,584,2488770
367,2,2,2495686,2495702,33,2494204,2495000,679,2495679
368,52,52,2502378,2503227,866,2501030,2501814,558,2502372
369,18,18,2509154,2509437,300,2507839,2508628,520,2509148
370,22,22,2516163,2516513,367,2514648,2515442,715,2516157
371,14,14,2522873,2523089,233,2521458,2522256,611,2522867
372,54,54,2529998,2530881,899,2528284,2529070,923,2529993
373,30,30,2536708,2537191,499,2535093,2535884,818,2536702
374,26,26,2543451,2543867,432,2541902,2542698,746,2543444
375,10,10,2550110,2550260,166,2548728,2549512,591,2550103
376,46,46,2557136,2557885,766,2555537,2556326,803,2557129
377,30,30,2564111,2564594,500,2562347,2563140,966,2564106
378,26,26,2570521,2570937,433,2569156,2569954,561,2570515
379,38,38,2577464,2578080,632,2575982,2576768,689,2577457
380,16,16,2584389,2584639,267,2582791,2583582,801,2584383
381,38,38,2591199,2591815,632,2589600,2590396,796,2591192
382,26,26,2597925,2598341,433,2596426,2597210,708,2597918
383,58,58,2604967,2605916,966,2603236,2604024,937,2604961
384,54,54,2611627,2612509,899,2610045,2610838,782,2611620
385,30,30,2618319,2618802,500,2616854,2617652,661,2618313
386,44,44,2625112,2625828,733,2623680,2624466,639,2625105
387,10,10,2632054,2632204,167,2630490,2631280,769,2632049
388,8,8,2638714,2638830,133,2637299,2638094,614,2638708
389,32,32,2645640,2646156,533,2644125,2644908,726,2645634
390,20,20,2652449,2652765,333,2650934,2651722,721,2652443
391,52,52,2659059,2659908,865,2657743,2658536,516,2659052
392,32,32,2666134,2666650,533,2664553,2665350,778,2666128
393,40,40,2672677,2673326,666,2671379,2672164,507,2672671
394,22,22,2679520,2679869,366,2678188,2678978,535,2679513
395,50,50,2686396,2687211,832,2684997,2685792,597,2686389
396,16,16,2693355,2693604,266,2691823,2692606,742,2693348
397,2,2,2700131,2700147,33,2698632,2699420,704,2700124
398,54,54,2706973,2707856,899,2705442,2706234,733,2706967
399,30,30,2713999,2714482,499,2712251,2713048,945,2713993
400,16,16,2720708,2720958,267,2719077,2719862,840,2720702
401,38,38,2727418,2728034,632,2725886,2726676,735,2727411
402,46,46,2734144,2734893,766,2732695,2733490,647,2734137
403,36,36,2741186,2741769,600,2739521,2740304,876,2741180
404,6,6,2747812,2747896,100,2746331,2747118,688,2747806
405,44,44,2754788,2755504,733,2753140,2753932,850,2754782
406,6,6,2761248,2761331,100,2759949,2760746,495,2761241
407,46,46,2768207,2768956,766,2766775,2767560,640,2768200
408,24,24,2775266,2775649,399,2773584,2774374,885,2775259
409,20,20,2782158,2782475,333,2780394,2781188,965,2782153
410,48,48,2788968,2789750,799,2787220,2788002,960,2788962
411,54,54,2795477,2796360,899,2794029,2794816,655,2795471
412,12,12,2802603,2802786,200,2800838,2801630,967,2802597
413,30,30,2809146,2809629,499,2807647,2808444,695,2809139
414,22,22,2816138,2816488,367,2814473,2815258,874,2816132
415,34,34,2822748,2823297,566,2821283,2822072,670,2822742
416,38,38,2829823,2830439,633,2828092,2828886,931,2829817
417,32,32,2836649,2837165,533,2834901,2835700,943,2836643
418,10,10,2843226,2843375,166,2841727,2842514,705,2843219
419,16,16,2849935,2850185,266,2848536,2849328,600,2849928
420,18,18,2857044,2857327,300,2855346,2856142,896,2857038
421,52,52,2863637,2864486,866,2862172,2862956,675,2863631
422,12,12,2869630,2869813,200,2868981,2868987,636,2869623
423,34,34,2876323,2876872,566,2875008,2875801,516,2876317
424,10,10,2882650,2882799,166,2881817,2881832,810,2882642
425,60,60,2889509,2890491,999,2887861,2888646,857,2889503
426,56,56,2896068,2896984,933,2894670,2895460,602,2896062
427,50,50,2903127,2903943,833,2901479,2902274,847,2903121
428,52,52,2909737,2910586,866,2908305,2909088,642,2909730
429,56,56,2916812,2917728,933,2915114,2915902,904,2916806
430,34,34,2923522,2924071,566,2921924,2922716,800,2923516
431,14,14,2930464,2930681,233,2928733,2929530,928,2930458
432,58,58,2937274,2938223,965,2935559,2936344,924,2937268
433,26,26,2943733,2944150,433,2942368,2943158,569,2943727
434,22,22,2950509,2950859,367,2949177,2949972,530,2950502
435,50,50,2957668,2958484,833,2956003,2956786,876,2957662
436,48,48,2964194,2964977,800,2962813,2963600,588,2964188
437,38,38,2971204,2971820,632,2969622,2970414,783,2971197
438,38,38,2977896,2978512,633,2976431,2977228,662,2977890
439,34,34,2984839,2985388,566,2983257,2984042,790,2984832
440,14,14,2991698,2991914,233,2990066,2990856,835,2991691
441,60,60,2998241,2999223,999,2996876,2997670,565,2998235
442,8,8,3005100,3005217,133,3003685,3004484,610,3005094
443,6,6,3012059,3012142,100,3010511,3011298,755,3012053
444,18,18,3018885,3019168,300,3017320,3018112,767,3018879
445,60,60,3025445,3026427,999,3024129,3024926,512,3025438
446,58,58,3032487,3033436,966,3030955,3031740,740,3032480
447,22,22,3039313,3039663,366,3037765,3038554,753,3039307
448,60,60,3045873,3046855,999,3044574,3045368,498,3045866
449,40,40,3052699,3053348,665,3051383,3052182,510,3052692
450,38,38,3059691,3060307,633,3058209,3058996,688,3059684
451,24,24,3066800,3067183,399,3065018,3065810,983,3066793
452,48,48,3073476,3074258,799,3071828,3072624,846,3073470
453,48,48,3080102,3080885,799,3078654,3079438,658,3080096
454,10,10,3086878,3087028,167,3085463,3086252,620,3086872
455,28,28,3093904,3094353,466,3092272,3093066,831,3093897
456,52,52,3100497,3101346,865,3099082,3099880,611,3100491
457,8,8,3107556,3107672,133,3105908,3106694,856,3107550
458,38,38,3114465,3115081,633,3112717,3113508,951,3114459
459,14,14,3121091,3121307,233,3119526,3120322,763,3121085
460,48,48,3127767,3128550,799,3126352,3127136,625,3127761
461,52,52,3134776,3135625,866,3133161,3133950,820,3134770
462,38,38,3141735,3142351,633,3139971,3140764,966,3141730
463,32,32,3148078,3148595,533,3146780,3147578,494,3148072
464,38,38,3154904,3155520,633,3153606,3154392,506,3154898
465,48,48,3162030,3162812,799,3160415,3161206,818,3162024
466,28,28,3168723,3169172,466,3167224,3168020,696,3168716
467,40,40,3175649,3176298,666,3174050,3174834,808,3175642
468,22,22,3182375,3182724,366,3180860,3181648,721,3182369
469,44,44,3189417,3190133,733,3187669,3188462,949,3189411
470,2,2,3195910,3195927,33,3194478,3195276,627,3195903
471,20,20,3202986,3203302,333,3201304,3202090,889,3202979
472,28,28,3209412,3209861,466,3208113,3208904,501,3209405
473,38,38,3216271,3216887,633,3214923,3215718,547,3216265
474,2,2,3223130,3223147,34,3221749,3222532,592,3223124
475,24,24,3230040,3230423,399,3228558,3229346,687,3230033
476,40,40,3236899,3237548,666,3235367,3236160,732,3236892
477,52,52,3243542,3244391,865,3242176,3242974,561,3243535
478,10,10,3250734,3250884,166,3249002,3249788,939,3250727
479,36,36,3257194,3257776,599,3255812,3256602,585,3257187
480,42,42,3263970,3264652,699,3262621,3263416,547,3263963
481,24,24,3271029,3271411,399,3269447,3270230,792,3271022
482,16,16,3277938,3278187,266,3276256,3277044,887,3277931
483,58,58,3284564,3285513,965,3283065,3283858,699,3284557
484,40,40,3291540,3292189,666,3289875,3290672,862,3291534
485,32,32,3297267,3297783,533,3296701,3296703,557,3297260
486,8,8,3304259,3304376,133,3302727,3303517,735,3304252
487,50,50,3311102,3311918,832,3309537,3310331,765,3311096
488,58,58,3317844,3318793,966,3316346,3317145,693,3317838
489,40,40,3324720,3325370,666,3323172,3323959,755,3324714
490,44,44,3331297,3332012,732,3329981,3330773,517,3331290
491,16,16,3338256,3338505,266,3336791,3337587,663,3338250
492,50,50,3344965,3345781,832,3343617,3344401,558,3344959
493,40,40,3352074,3352723,666,3350426,3351215,853,3352068
494,14,14,3358783,3359000,234,3357235,3358029,748,3358777
495,46,46,3365709,3366458,766,3364061,3364843,860,3365703
496,38,38,3372485,3373101,633,3370870,3371657,822,3372479
497,20,20,3379078,3379394,333,3377680,3378471,601,3379072
498,14,14,3386220,3386437,233,3384489,3385285,929,3386214
499,42,42,3393080,3393762,699,3391315,3392099,975,3393074
500,22,22,3399606,3399955,366,3398124,3398913,686,3399599
501,44,44,3406365,3407081,733,3404933,3405727,631,3406358
502,34,34,3413308,3413857,566,3411743,3412541,761,3413302
503,48,48,3420034,3420816,799,3418569,3419355,673,3420028
504,16,16,3426876,3427126,267,3425378,3426169,701,3426870
505,10,10,3433502,3433652,167,3432187,3432983,513,3433496
506,40,40,3440728,3441377,666,3439013,3439797,925,3440722
507,40,40,3447188,3447837,666,3445822,3446611,570,3447181
508,4,4,3453930,3453980,67,3452632,3453425,499,3453924
509,10,10,3461056,3461206,166,3459441,3460239,811,3461050
510,28,28,3467998,3468448,467,3466267,3467053,939,3467992
511,22,22,3474758,3475107,366,3473076,3473867,884,3474751
512,8,8,3481201,3481317,133,3479885,3480681,513,3481194
513,60,60,3488110,3489092,999,3486711,3487495,608,3488103
514,12,12,3494803,3494986,199,3493521,3494309,487,3494796
515,10,10,3502078,3502228,167,3500330,3501123,949,3502072
516,30,30,3508887,3509370,500,3507139,3507937,944,3508881
517,26,26,3515347,3515763,433,3513965,3514751,589,3515340
518,50,50,3522456,3523272,832,3520774,3521565,884,3522449
519,60,60,3528932,3529915,999,3527584,3528379,547,3528926
520,16,16,3536141,3536391,267,3534410,3535193,942,3536135
521,46,46,3542784,3543533,766,3541219,3542007,771,3542778
522,48,48,3549393,3550176,800,3548028,3548821,566,3549387
523,28,28,3556236,3556686,466,3554838,3555635,595,3556230
524,14,14,3563345,3563561,233,3561663,3562449,889,3563338
525,54,54,3570104,3570987,899,3568473,3569263,835,3570098
526,14,14,3577063,3577280,234,3575282,3576077,980,3577057
527,48,48,3583706,3584489,799,3582108,3582891,809,3583700
528,14,14,3590266,3590482,233,3588917,3589705,554,3590259
529,6,6,3597408,3597491,100,3595727,3596519,883,3597402
530,12,12,3603934,3604117,200,3602536,3603333,595,3603928
531,36,36,3610694,3611276,599,3609362,3610147,540,3610687
532,20,20,3617620,3617936,332,3616171,3616961,652,3617613
533,48,48,3624662,3625444,799,3622980,3623775,880,3624655
534,12,12,3631188,3631371,200,3629806,3630589,592,3631181
535,60,60,3638214,3639196,999,3636616,3637403,805,3638208
536,32,32,3645140,3645656,532,3643425,3644217,917,3645134
537,44,44,3652016,3652731,732,3650234,3651031,978,3652009
538,26,26,3658509,3658925,432,3657060,3657845,657,3658502
539,38,38,3665185,3665801,632,3663869,3664659,519,3665178
540,2,2,3672443,3672460,34,3670679,3671473,965,3672438
541,50,50,3678886,3679702,833,3677505,3678287,593,3678880
542,26,26,3685662,3686079,433,3684314,3685101,555,3685656
543,36,36,3692472,3693054,599,3691123,3691915,550,3692465
544,50,50,3699281,3700097,832,3697932,3698729,545,3699274
545,50,50,3706174,3706989,832,3704758,3705543,624,3706167
546,44,44,3712950,3713665,732,3711568,3712357,586,3712943
547,56,56,3719709,3720625,932,3718377,3719171,531,3719702
548,44,44,3726735,3727450,732,3725186,3725985,743,3726728
549,58,58,3733727,3734676,966,3732012,3732799,922,3733721
550,36,36,3740536,3741119,600,3738821,3739613,917,3740530
551,26,26,3747396,3747812,432,3745631,3746427,963,3747390
552,26,26,3753839,3754255,432,3752457,3753241,591,3753832
553,52,52,3760714,3761563,866,3759266,3760055,653,3760708
554,20,20,3767674,3767990,333,3766075,3766869,798,3767667
555,22,22,3774333,3774683,366,3772885,3773683,644,3774327
556,10,10,3781309,3781459,166,3779710,3780497,805,3781302
557,12,12,3788218,3788401,200,3786520,3787311,901,3788212
558,34,34,3794694,3795244,566,3793329,3794125,563,3794688
559,24,24,3801836,3802219,400,3800155,3800939,891,3801830
560,58,58,3808429,3809378,966,3806964,3807753,670,3808423
561,44,44,3815438,3816154,733,3813774,3814567,866,3815433
562,60,60,3821948,3822930,999,3820583,3821381,561,3821942
563,52,52,3828741,3829590,865,3827409,3828195,539,3828734
564,24,24,3835750,3836133,399,3834218,3835009,734,3835743
565,6,6,3842376,3842459,100,3841027,3841823,546,3842369
566,54,54,3849218,3850101,900,3847853,3848637,575,3849212
567,34,34,3856411,3856960,566,3854663,3855451,954,3856405
568,24,24,3862870,3863253,400,3861472,3862265,599,3862864
569,16,16,3869963,3870212,266,3868281,3869079,877,3869956
570,40,40,3876539,3877188,666,3875107,3875893,639,3876532
571,16,16,3883365,3883615,266,3881916,3882707,651,3883358
572,22,22,3890457,3890807,366,3888726,3889521,930,3890451
573,48,48,3897117,3897899,799,3895552,3896335,776,3897111
574,4,4,3904026,3904076,66,3902361,3903149,871,3904020
575,12,12,3910702,3910885,200,3909170,3909963,732,3910695
576,52,52,3917661,3918510,866,3915979,3916777,877,3917654
577,38,38,3924454,3925070,632,3922805,3923591,856,3924447
578,6,6,3930913,3930996,100,3929615,3930405,502,3930907
579,56,56,3937123,3938039,933,3936424,3936436,680,3937116
580,50,50,3943883,3944698,832,3942467,3943250,626,3943876
581,42,42,3950725,3951408,699,3949277,3950064,655,3950719
582,28,28,3957767,3958217,467,3956086,3956878,883,3957761
583,38,38,3964344,3964960,632,3962895,3963692,645,3964337
584,34,34,3971220,3971769,566,3969721,3970506,707,3971213
585,36,36,3977862,3978445,600,3976530,3977320,535,3977855
586,60,60,3984772,3985754,998,3983340,3984134,631,3984765
587,60,60,3991614,3992596,999,3990149,3990948,660,3991608
588,24,24,3998340,3998723,400,3996975,3997762,572,3998334
589,48,48,4005316,4006098,799,4003784,4004576,733,4005309
590,36,36,4012075,4012658,600,4010594,4011390,679,4012069
591,38,38,4019118,4019734,632,4017419,4018204,907,4019111
592,36,36,4025677,4026260,600,4024229,4025018,653,4025671
593,2,2,4032520,4032536,33,4031038,4031832,681,4032513
594,42,42,4039163,4039845,699,4037847,4038646,510,4039156
595,8,8,4046205,4046321,133,4044673,4045460,738,4046198
596,28,28,4053214,4053664,466,4051483,4052274,934,4053208
597,52,52,4059724,4060573,865,4058292,4059088,629,4059717
598,6,6,4066883,4066966,99,4065118,4065902,975,4066877
599,6,6,4073575,4073659,100,4071927,4072716,853,4073569
600,30,30,4080335,4080817,499,4078736,4079530,798,4080328
601,42,42,4087027,4087710,700,4085546,4086344,677,4087021
602,34,34,4093720,4094270,566,4092372,4093158,556,4093714
603,4,4,4100812,4100862,67,4099181,4099972,834,4100806
604,20,20,4107389,4107705,333,4105990,4106786,596,4107382
605,2,2,4114581,4114597,33,4112816,4113600,975,4114575
606,58,58,4121207,4122156,966,4119625,4120414,786,4121200
607,2,2,4127983,4128000,33,4126435,4127228,749,4127977
608,12,12,4134925,4135109,200,4133244,4134042,877,4134919
609,20,20,4141585,4141901,333,4140070,4140856,723,4141579
610,2,2,4148211,4148228,33,4146879,4147670,534,4148204
611,12,12,4155337,4155520,199,4153688,4154484,846,4155330
612,16,16,4161946,4162196,267,4160514,4161298,641,4161939
613,50,50,4168955,4169771,833,4167324,4168112,837,4168949
614,28,28,4175698,4176147,466,4174133,4174926,766,4175692
615,6,6,4182640,4182724,100,4180942,4181740,894,4182634
616,34,34,4189167,4189716,566,4187768,4188554,606,4189160
617,12,12,4196259,4196442,200,4194577,4195368,884,4196252
618,56,56,4202735,4203651,933,4201387,4202182,547,4202729
619,20,20,4209944,4210260,333,4208213,4208996,942,4209938
620,12,12,4216670,4216853,200,4215022,4215810,854,4216664
621,12,12,4223496,4223679,200,4221831,4222624,866,4223490
622,26,26,4230405,4230821,433,4228641,4229438,962,4230400
623,10,10,4236748,4236898,167,4235466,4236252,489,4236741
624,46,46,4243774,4244523,766,4242276,4243066,702,4243768
625,30,30,4250800,4251283,499,4249085,4249880,914,4250794
626,4,4,4257626,4257676,66,4255911,4256694,926,4257620
627,26,26,4264119,4264535,433,4262720,4263508,604,4264112
628,32,32,4271128,4271644,533,4269530,4270322,800,4271122
629,10,10,4277671,4277821,166,4276339,4277136,528,4277664
630,52,52,4284796,4285645,866,4283165,4283950,840,4284790
631,30,30,4291656,4292138,499,4289974,4290764,885,4291649
632,16,16,4298099,4298348,266,4296783,4297578,514,4298092
633,16,16,4305091,4305341,266,4303609,4304392,692,4305084
634,42,42,4312067,4312749,699,4310419,4311206,855,4312061
635,34,34,4318976,4319525,566,4317228,4318020,950,4318970
636,50,50,4325669,4326484,832,4324037,4324834,828,4325662
637,26,26,4332145,4332561,433,4330863,4331648,490,4332138
638,54,54,4339287,4340170,899,4337672,4338462,819,4339281
639,20,20,4345863,4346180,333,4344482,4345276,581,4345857
640,26,26,4352989,4353405,433,4351308,4352090,893,4352983
641,34,34,4359599,4360148,566,4358117,4358904,688,4359592
642,12,12,4366291,4366474,200,4364926,4365718,567,4366285
643,18,18,4373417,4373700,300,4371735,4372532,878,4373410
644,26,26,4380210,4380626,432,4378561,4379346,857,4380203
645,8,8,4387102,4387219,133,4385371,4386160,936,4387096
646,28,28,4393861,4394311,467,4392180,4392974,881,4393855
647,34,34,4400538,4401087,566,4398989,4399788,743,4400531
648,8,8,4407447,4407563,133,4405815,4406602,838,4407440
649,50,50,4414040,4414855,832,4412624,4413416,617,4414033
650,14,14,4420782,4420999,233,4419434,4420230,546,4420776
651,28,28,4427741,4428191,467,4426260,4427044,691,4427735
652,24,24,4434817,4435200,400,4433069,4433858,953,4434811
653,22,22,4441493,4441843,366,4439878,4440672,815,4441487
654,54,54,4448286,4449168,899,4446688,4447486,794,4448280
655,30,30,4454879,4455361,499,4453513,4454300,572,4454872
656,42,42,4461921,4462604,699,4460323,4461114,801,4461915
657,32,32,4468714,4469230,532,4467132,4467928,779,4468707
658,54,54,4475290,4476172,899,4473958,4474742,541,4475283
659,24,24,4482049,4482432,400,4480767,4481556,486,4482042
660,14,14,4489341,4489558,233,4487577,4488370,966,4489336
661,26,26,4496034,4496450,433,4494386,4495184,844,4496028
662,12,12,4502993,4503176,200,4501212,4501998,989,4502987
663,16,16,4509686,4509936,266,4508021,4508812,868,4509680
664,36,36,4516512,4517095,599,4514830,4515626,879,4516505
665,24,24,4523021,4523404,400,4521656,4522440,575,4523015
666,42,42,4529881,4530563,699,4528466,4529254,621,4529875
667,16,16,4536740,4536990,266,4535275,4536068,666,4536734
668,6,6,4543666,4543749,100,4542084,4542882,777,4543659
669,52,52,4550342,4551191,866,4548910,4549696,639,4550335
670,16,16,4557035,4557284,266,4555719,4556510,518,4557028
671,14,14,4563827,4564044,233,4562529,4563324,497,4563821
672,26,26,4570670,4571086,433,4569355,4570138,526,4570664
673,8,8,4577529,4577646,133,4576164,4576952,571,4577523
674,2,2,4584372,4584388,33,4582973,4583766,599,4584365
675,24,24,4591331,4591714,399,4589782,4590580,744,4591324
676,58,58,4598123,4599072,966,4596608,4597394,723,4598117
677,48,48,4604783,4605565,799,4603418,4604208,569,4604777
678,54,54,4611642,4612524,899,4610227,4611022,614,4611636
679,46,46,4618568,4619317,766,4617053,4617836,726,4618562
680,60,60,4625311,4626293,998,4623862,4624650,654,4625304
681,2,2,4632453,4632469,33,4630671,4631464,982,4632446
682,6,6,4639262,4639345,100,4637481,4638278,978,4639256
683,44,44,4646071,4646787,733,4644307,4645092,974,4646066
684,8,8,4652614,4652731,133,4651116,4651906,702,4652608
685,60,60,4659673,4660656,999,4657925,4658720,947,4659667
686,56,56,4666233,4667149,932,4664751,4665534,692,4666226
687,26,26,4672859,4673275,433,4671560,4672348,504,4672852
688,14,14,4680085,4680301,233,4678370,4679162,917,4680079
689,28,28,4686827,4687277,466,4685179,4685976,845,4686821
690,38,38,4693753,4694369,633,4692005,4692790,957,4693747
691,6,6,4700263,4700346,100,4698814,4699604,652,4700256
692,10,10,4707255,4707405,167,4705623,4706418,830,4707248
693,10,10,4713931,4714081,167,4712449,4713232,692,4713924
694,24,24,4720591,4720974,399,4719259,4720046,538,4720584
695,2,2,4727367,4727383,33,4726068,4726860,500,4727360
696,30,30,4734476,4734958,499,4732877,4733674,795,4734469
697,46,46,4741102,4741851,766,4739703,4740488,607,4741095
698,46,46,4748177,4748927,766,4746513,4747302,870,4748172
699,48,48,4754620,4755403,800,4753322,4754116,498,4754614
700,32,32,4761446,4761962,533,4760131,4760930,510,4761440
701,58,58,4768339,4769288,965,4766957,4767744,588,4768332
702,44,44,4775431,4776147,733,4773766,4774558,867,4775425
703,24,24,4781891,4782274,399,4780576,4781372,513,4781885
704,56,56,4788767,4789682,932,4787402,4788186,575,4788761
705,56,56,4795676,4796592,932,4794211,4795000,670,4795670
706,24,24,4802352,4802735,400,4801020,4801814,531,4802345
707,46,46,4809561,4810310,766,4807829,4808628,926,4809554
708,32,32,4816304,4816820,532,4814655,4815442,855,4816297
709,58,58,4823196,4824145,966,4821465,4822256,934,4823190
710,58,58,4829905,4830854,966,4828274,4829070,829,4829899
711,46,46,4836398,4837148,766,4835100,4835884,508,4836392
712,8,8,4843391,4843507,133,4841909,4842698,686,4843384
713,58,58,4850167,4851116,965,4848718,4849512,648,4850160
714,20,20,4857259,4857575,333,4855528,4856326,927,4857253
715,18,18,4863952,4864235,300,4862354,4863140,806,4863946
716,54,54,4870695,4871577,899,4869163,4869954,734,4870688
717,44,44,4877520,4878236,733,4875972,4876768,746,4877514
718,36,36,4884430,4885012,599,4882798,4883582,841,4884423
719,40,40,4891039,4891688,666,4889607,4890396,636,4891032
720,6,6,4897799,4897882,99,4896417,4897210,582,4897792
721,58,58,4905007,4905956,966,4903226,4904024,977,4905001
722,38,38,4911550,4912166,633,4910052,4910838,706,4911544
723,10,10,4918543,4918693,166,4916861,4917652,884,4918536
724,36,36,4925369,4925951,599,4923670,4924466,896,4925362
725,54,54,4932211,4933094,899,4930496,4931280,925,4932205
726,50,50,4938887,4939703,833,4937306,4938094,787,4938881
727,46,46,4945430,4946179,766,4944115,4944908,516,4945424
728,10,10,4952456,4952606,166,4950924,4951722,727,4952449
729,58,58,4959249,4960198,965,4957750,4958536,706,4959242
730,40,40,4965925,4966574,666,4964559,4965350,568,4965918
731,58,58,4973084,4974033,965,4971369,4972164,914,4973078
732,18,18,4979743,4980026,300,4978195,4978978,759,4979737
733,54,54,4986602,4987485,899,4985004,4985792,804,4986596
734,40,40,4993312,4993961,666,4991813,4992606,699,4993305
735,32,32,5000004,5000521,533,4998623,4999420,578,4999998
736,26,26,5007013,5007430,433,5005448,5006234,773,5007007
737,46,46,5013973,5014722,765,5012258,5013048,919,5013967
738,42,42,5020782,5021464,699,5019067,5019862,914,5020776
739,22,22,5027425,5027774,366,5025893,5026676,742,5027418
740,12,12,5034101,5034284,200,5032702,5033490,604,5034094
741,18,18,5041293,5041576,300,5039512,5040304,983,5041287
742,52,52,5047803,5048652,865,5046321,5047118,678,5047796
743,50,50,5054778,5055594,833,5053147,5053932,840,5054772
744,58,58,5061421,5062370,966,5059956,5060746,669,5061415
745,22,22,5068214,5068563,366,5066765,5067560,647,5068207
746,52,52,5075173,5076022,866,5073591,5074374,792,5075166
747,42,42,5081899,5082582,699,5080401,5081188,705,5081893
748,24,24,5088875,5089258,399,5087210,5088002,867,5088869
749,48,48,5095368,5096150,799,5094019,5094816,545,5095361
750,36,36,5102443,5103026,600,5100845,5101630,807,5102437
751,8,8,5109169,5109286,134,5107654,5108444,719,5109163
752,4,4,5116079,5116129,66,5114464,5115258,815,5116073
753,22,22,5122671,5123021,367,5121290,5122072,593,5122665
754,60,60,5129447,5130430,999,5128099,5128886,555,5129441
755,18,18,5136506,5136789,300,5134908,5135700,800,5136500
756,34,34,5143432,5143982,566,5141717,5142514,912,5143426
757,42,42,5149842,5150525,699,5148543,5149328,507,5149835
758,36,36,5156951,5157534,599,5155353,5156142,803,5156945
759,8,8,5163477,5163594,133,5162162,5162956,515,5163471
760,46,46,5170603,5171352,766,5168971,5169770,826,5170596
761,56,56,5177395,5178311,933,5175797,5176584,805,5177389
762,8,8,5184288,5184405,133,5182606,5183398,883,5184281
763,48,48,5191031,5191813,799,5189416,5190212,813,5191025
764,58,58,5197890,5198839,966,5196242,5197026,858,5197884
765,36,36,5204483,5205065,599,5203051,5203840,636,5204476
766,40,40,5211625,5212274,666,5209860,5210654,965,5211619
767,8,8,5218018,5218135,133,5216670,5217468,544,5218012
768,16,16,5225244,5225493,266,5223495,5224282,955,5225237
769,52,52,5232053,5232902,866,5230305,5231096,951,5232047
770,44,44,5238912,5239628,733,5237114,5237910,996,5238906
771,18,18,5245305,5245588,300,5243940,5244724,575,5245299
772,28,28,5252447,5252897,467,5250749,5251538,903,5252441
773,26,26,5258940,5259357,433,5257559,5258352,582,5258934
774,36,36,5266099,5266682,600,5264368,5265166,927,5266093
775,28,28,5272809,5273258,466,5271194,5271980,823,5272803
776,56,56,5279685,5280600,932,5278003,5278794,884,5279678
777,32,32,5286327,5286843,533,5284812,5285608,713,5286321
778,14,14,5292970,5293187,233,5291638,5292422,541,5292963
779,52,52,5300162,5301011,866,5298448,5299236,921,5300157
780,12,12,5306739,5306922,199,5305257,5306050,682,5306732
781,50,50,5313648,5314464,832,5312066,5312864,777,5313641
782,44,44,5320291,5321006,732,5318892,5319678,606,5320284
783,38,38,5327083,5327699,633,5325701,5326492,584,5327076
784,60,60,5333959,5334941,999,5332511,5333306,647,5333953
785,14,14,5340635,5340852,233,5339337,5340120,509,5340629
786,12,12,5347877,5348060,200,5346146,5346934,937,5347871
787,30,30,5354287,5354770,500,5352955,5353748,532,5354280
788,46,46,5361246,5361995,766,5359764,5360562,677,5361239
789,46,46,5368039,5368788,766,5366590,5367376,656,5368032
790,42,42,5374965,5375647,699,5373400,5374190,769,5374959
791,24,24,5381524,5381907,400,5380209,5381004,514,5381518
792,40,40,5388500,5389149,666,5387035,5387818,676,5388494
793,60,60,5395359,5396341,999,5393844,5394632,721,5395353
794,16,16,5402268,5402518,267,5400653,5401446,816,5402262
795,22,22,5409111,5409461,366,5407463,5408260,845,5409105
796,44,44,5416037,5416753,732,5414289,5415074,957,5416031
797,56,56,5422646,5423562,933,5421098,5421888,752,5422640
798,46,46,5429639,5430388,766,5427907,5428702,930,5429632
799,46,46,5436065,5436814,766,5434733,5435516,542,5436058
800,20,20,5443241,5443557,333,5441542,5442330,904,5443234
801,6,6,5450033,5450116,100,5448352,5449144,883,5450027
802,38,38,5456759,5457375,633,5455161,5455958,795,5456753
803,32,32,5463352,5463868,533,5461987,5462772,574,5463346
804,44,44,5470444,5471160,733,5468796,5469586,852,5470438
805,6,6,5477121,5477204,99,5475606,5476400,715,5477115
806,6,6,5483913,5483996,100,5482431,5483214,692,5483906
807,10,10,5490573,5490722,166,5489241,5490028,538,5490566
808,14,14,5497349,5497565,233,5496050,5496842,500,5497342
809,28,28,5504641,5505090,466,5502859,5503656,978,5504634
810,42,42,5510967,5511650,699,5509685,5510470,490,5510960
811,4,4,5518010,5518060,66,5516495,5517284,720,5518004
812,2,2,5524885,5524902,34,5523304,5524098,781,5524879
813,52,52,5531761,5532610,866,5530113,5530912,843,5531755
814,8,8,5538521,5538637,133,5536939,5537726,788,5538514
815,50,50,5545180,5545996,833,5543748,5544540,633,5545173
816,50,50,5552073,5552888,832,5550558,5551354,713,5552067
817,6,6,5558832,5558915,100,5557384,5558168,658,5558826
818,40,40,5565641,5566291,666,5564193,5564982,653,5565635
819,20,20,5572484,5572800,333,5571002,5571796,681,5572477
820,6,6,5579376,5579460,100,5577811,5578610,760,5579370
821,16,16,5585953,5586202,266,5584637,5585424,522,5585946
822,56,56,5593095,5594011,932,5591447,5592238,851,5593089
823,44,44,5599588,5600304,732,5598256,5599052,529,5599581
824,60,60,5606530,5607513,999,5605082,5605866,658,5606524
825,46,46,5613606,5614355,766,5611891,5612680,920,5613600
826,60,60,5620149,5621131,999,5618700,5619494,648,5620142
827,48,48,5626842,5627624,799,5625510,5626308,527,5626835
828,8,8,5633717,5633834,134,5632336,5633122,589,5633711
829,28,28,5640660,5641109,466,5639145,5639936,718,5640654
830,32,32,5647702,5648218,533,5645954,5646750,946,5647696
831,50,50,5654212,5655028,832,5652780,5653564,641,5654205
832,10,10,5661104,5661254,167,5659589,5660378,720,5661098
833,48,48,5668130,5668913,799,5666399,5667192,932,5668124
834,26,26,5674656,5675073,433,5673208,5674006,644,5674650
835,38,38,5681699,5682315,632,5680034,5680820,873,5681693
836,52,52,5688408,5689257,866,5686843,5687634,768,5688402
837,56,56,5695118,5696033,932,5693653,5694448,664,5695112
838,52,52,5702193,5703042,866,5700478,5701262,925,5702187
839,22,22,5708686,5709036,367,5707288,5708076,604,5708680
840,22,22,5715612,5715962,366,5714097,5714890,716,5715606
841,56,56,5722638,5723553,932,5720906,5721704,927,5722631
842,36,36,5729231,5729813,599,5727732,5728518,706,5729224
843,54,54,5735923,5736806,899,5734542,5735332,585,5735917
844,22,22,5742849,5743199,366,5741351,5742146,697,5742843
845,4,4,5749858,5749908,67,5748177,5748960,892,5749852
846,30,30,5756651,5757134,499,5754986,5755774,871,5756645
847,40,40,5763277,5763926,666,5761795,5762588,682,5763270
848,28,28,5770336,5770786,466,5768605,5769402,928,5770330
849,22,22,5777062,5777412,366,5775431,5776216,840,5777056
850,28,28,5783755,5784204,466,5782240,5783030,719,5783749
851,28,28,5790747,5791197,466,5789049,5789844,897,5790741
852,30,30,5797207,5797690,499,5795875,5796658,542,5797200
853,24,24,5804066,5804449,400,5802684,5803472,587,5804059
854,20,20,5811042,5811358,333,5809494,5810286,750,5811036
855,2,2,5818084,5818101,34,5816303,5817100,978,5818078
856,30,30,5824744,5825227,499,5823129,5823914,824,5824738
857,34,34,5831470,5832019,566,5829938,5830728,735,5831463
858,28,28,5838146,5838595,466,5836747,5837542,597,5838139
859,36,36,5844889,5845471,599,5843573,5844356,526,5844882
860,26,26,5851715,5852131,432,5850383,5851170,538,5851708
861,2,2,5858491,5858507,33,5857192,5857984,500,5858484
862,26,26,5865649,5866066,433,5864001,5864798,845,5865643
863,8,8,5872542,5872658,133,5870827,5871612,924,5872536
864,20,20,5879401,5879717,333,5877636,5878426,969,5879395
865,28,28,5886111,5886560,466,5884446,5885240,865,5886105
866,28,28,5892753,5893203,467,5891255,5892054,693,5892747
867,36,36,5899429,5900012,600,5898081,5898868,555,5899423
868,28,28,5906588,5907038,467,5904890,5905682,900,5906582
869,38,38,5913165,5913781,632,5911699,5912496,662,5913158
870,36,36,5919957,5920540,600,5918525,5919310,640,5919950
871,28,28,5927000,5927449,466,5925335,5926124,870,5926994
872,6,6,5933692,5933776,100,5932144,5932938,748,5933686
873,52,52,5940385,5941234,866,5938953,5939752,626,5940378
874,22,22,5947427,5947777,367,5945779,5946566,855,5947421
875,18,18,5954320,5954603,300,5952589,5953380,934,5954314
876,6,6,5961029,5961113,100,5959398,5960194,829,5961023
877,8,8,5967672,5967789,133,5966224,5967008,658,5967666
878,16,16,5974798,5975047,266,5973033,5973822,970,5974792
879,28,28,5981424,5981873,466,5979842,5980636,781,5981417
880,8,8,5988283,5988400,133,5986652,5987450,827,5988277
881,32,32,5995192,5995708,533,5993478,5994264,923,5995187
882,16,16,6002002,6002251,266,6000287,6001078,918,6001996
883,18,18,6008495,6008778,299,6007096,6007892,596,6008488
884,30,30,6015537,6016020,499,6013922,6014706,825,6015531
885,24,24,6022463,6022846,399,6020731,6021520,936,6022456
886,16,16,6028939,6029189,266,6027541,6028334,599,6028933
887,28,28,6036048,6036498,466,6034350,6035148,894,6036042
888,6,6,6042907,6042991,100,6041176,6041962,939,6042901
889,38,38,6049583,6050199,633,6047985,6048776,801,6049577
890,18,18,6056592,6056875,300,6054794,6055590,996,6056586
891,26,26,6063152,6063568,433,6061620,6062404,741,6063145
892,30,30,6070161,6070644,500,6068430,6069218,937,6070155
893,40,40,6077020,6077670,666,6075239,6076032,982,6077014
894,4,4,6083713,6083763,67,6082048,6082846,861,6083707
895,16,16,6090239,6090489,267,6088874,6089660,573,6090233
896,36,36,6097415,6097998,599,6095683,6096474,934,6097408
897,54,54,6104174,6105057,899,6102493,6103288,880,6104168
898,34,34,6110784,6111333,566,6109319,6110102,676,6110778
899,16,16,6117809,6118059,267,6116128,6116916,887,6117803
900,30,30,6124236,6124719,499,6122937,6123730,499,6124229
901,42,42,6131511,6132194,699,6129746,6130544,961,6131505
902,10,10,6138237,6138387,167,6136572,6137358,873,6138231
903,34,34,6144813,6145363,567,6143382,6144172,635,6144807
904,14,14,6151573,6151789,233,6150191,6150986,580,6151566
905,20,20,6158382,6158698,333,6157017,6157800,576,6158376
906,32,32,6165608,6166124,532,6163826,6164614,987,6165601
907,42,42,6172234,6172916,699,6170635,6171428,799,6172227
908,14,14,6178910,6179126,233,6177445,6178242,662,6178904
909,36,36,6185769,6186352,599,6184271,6185056,707,6185763
910,6,6,6192429,6192512,99,6191080,6191870,552,6192422
911,50,50,6199388,6200203,832,6197889,6198684,697,6199381
912,30,30,6205997,6206480,500,6204715,6205498,492,6205990
913,4,4,6213073,6213123,66,6211524,6212312,754,6213066
914,26,26,6219965,6220382,433,6218334,6219126,833,6219959
915,30,30,6226525,6227008,499,6225143,6225940,578,6226518
916,8,8,6233634,6233750,133,6231969,6232754,874,6233628
917,22,22,6240443,6240793,366,6238778,6239568,869,6240437
918,4,4,6247336,6247386,66,6245588,6246382,948,6247330
919,58,58,6254028,6254977,966,6252414,6253196,827,6254023
920,28,28,6260538,6260988,466,6259223,6260010,522,6260532
921,10,10,6267764,6267913,166,6266032,6266824,933,6267757
922,24,24,6274207,6274589,399,6272841,6273638,562,6274200
923,60,60,6281116,6282098,999,6279667,6280452,657,6281109
924,12,12,6287825,6288008,200,6286477,6287266,553,6287819
925,44,44,6294718,6295434,732,6293286,6294080,631,6294711
926,4,4,6301677,6301727,66,6300095,6300894,776,6301670
927,46,46,6308669,6309418,766,6306921,6307708,955,6308663
928,8,8,6315412,6315528,133,6313730,6314522,883,6315405
929,4,4,6322221,6322271,67,6320540,6321336,879,6322215
930,14,14,6329080,6329297,234,6327366,6328150,925,6329075
931,58,58,6335607,6336556,965,6334175,6334964,636,6335600
932,22,22,6342699,6343049,366,6340984,6341778,915,6342693
933,20,20,6349542,6349858,333,6347793,6348592,943,6349535
934,26,26,6356084,6356501,433,6354619,6355406,672,6356078
935,4,4,6362744,6362794,67,6361429,6362220,518,6362738
936,24,24,6369570,6369953,399,6368238,6369034,529,6369563
937,8,8,6376795,6376912,134,6375064,6375848,941,6376789
938,28,28,6383471,6383921,467,6381873,6382662,803,6383465
939,42,42,6390331,6391013,699,6388682,6389476,848,6390324
940,58,58,6397157,6398106,965,6395492,6396290,861,6397151
941,40,40,6402867,6403516,666,6402318,6402321,539,6402860
942,32,32,6409776,6410292,533,6408344,6409135,634,6409769
943,10,10,6416469,6416619,167,6415154,6415949,514,6416463
944,52,52,6423744,6424594,866,6421980,6422763,976,6423739
945,4,4,6430071,6430121,67,6428789,6429577,487,6430064
946,28,28,6437213,6437663,466,6435598,6436391,816,6437207
947,30,30,6444039,6444522,500,6442408,6443205,828,6444033
948,10,10,6450715,6450865,167,6449233,6450019,689,6450708
949,4,4,6457391,6457441,67,6456043,6456833,552,6457385
950,46,46,6464151,6464900,766,6462852,6463647,497,6464144
951,40,40,6470977,6471626,666,6469678,6470461,509,6470970
952,10,10,6478235,6478385,167,6476487,6477275,954,6478229
953,36,36,6484662,6485244,599,6483297,6484089,567,6484656
954,28,28,6491854,6492303,466,6490106,6490903,945,6491848
955,38,38,6498230,6498846,633,6496932,6497717,507,6498224
956,44,44,6505323,6506039,732,6503741,6504531,785,6505316
957,4,4,6512232,6512282,66,6510550,6511345,880,6512225
958,58,58,6518941,6519890,966,6517376,6518159,776,6518935
959,8,8,6525884,6526000,133,6524186,6524973,905,6525878
960,48,48,6532576,6533359,800,6530995,6531787,783,6532570
961,10,10,6539203,6539352,166,6537804,6538601,595,6539196
962,50,50,6546295,6547111,832,6544630,6545415,874,6546289
963,54,54,6552954,6553837,899,6551439,6552229,719,6552948
964,44,44,6559614,6560330,732,6558249,6559043,565,6559608
965,20,20,6566806,6567122,333,6565075,6565857,943,6566800
966,24,24,6573249,6573632,400,6571884,6572671,572,6573243
967,20,20,6580225,6580541,333,6578693,6579485,733,6580218
968,60,60,6587167,6588150,999,6585502,6586299,862,6587161
969,48,48,6593610,6594393,799,6592328,6593113,490,6593603
970,10,10,6600852,6601002,167,6599138,6599927,920,6600847
971,28,28,6606613,6607062,466,6605947,6605958,648,6606606
972,8,8,6613755,6613872,133,6611974,6612772,977,6613749
973,60,60,6620481,6621463,999,6618800,6619586,889,6620475
974,38,38,6627141,6627757,632,6625609,6626400,734,6627134
975,34,34,6633933,6634483,566,6632418,6633214,713,6633927
976,4,4,6640693,6640743,66,6639244,6640028,658,6640686
977,2,2,6647718,6647735,34,6646053,6646842,870,6647712
978,32,32,6654628,6655144,532,6652863,6653656,966,6654622
979,54,54,6661270,6662153,899,6659672,6660470,794,6661264
980,6,6,6667896,6667980,100,6666498,6667284,606,6667890
981,18,18,6674955,6675239,300,6673307,6674098,851,6674949
982,44,44,6681781,6682497,733,6680117,6680912,864,6681776
983,42,42,6688591,6689273,699,6686942,6687726,858,6688584
984,42,42,6695217,6695899,699,6693752,6694540,671,6695211
985,12,12,6702276,6702459,200,6700561,6701354,916,6702270
986,52,52,6708769,6709618,866,6707370,6708168,594,6708762
987,12,12,6715861,6716044,200,6714196,6714982,873,6715855
988,54,54,6722437,6723320,899,6721006,6721796,635,6722431
989,24,24,6729113,6729496,400,6727815,6728610,497,6729107
990,16,16,6736156,6736406,266,6734641,6735424,726,6736150
991,6,6,6742998,6743082,100,6741450,6742238,754,6742992
992,8,8,6749991,6750107,133,6748259,6749052,932,6749984
993,10,10,6756550,6756700,167,6755069,6755866,678,6756544
994,54,54,6763326,6764209,899,6761895,6762680,640,6763320
995,8,8,6770202,6770319,133,6768704,6769494,702,6770196
996,32,32,6776845,6777361,533,6775513,6776308,530,6776838
997,16,16,6783688,6783937,266,6782339,6783122,559,6783681
998,26,26,6790747,6791163,433,6789148,6789936,804,6790740
999,52,52,6797656,6798505,866,6795958,6796750,900,6797650
1000,8,8,6804199,6804315,133,6802767,6803564,628,6804192
1001,14,14,6810925,6811141,233,6809593,6810378,540,6810918
1002,56,56,6818017,6818933,932,6816402,6817192,819,6818011
1003,32,32,6824577,6825093,532,6823211,6824006,564,6824570
1004,8,8,6831652,6831769,134,6830037,6830820,826,6831646
1005,8,8,6838578,6838695,133,6836847,6837634,938,6838572
1006,18,18,6845171,6845454,300,6843656,6844448,717,6845165
1007,56,56,6851814,6852729,932,6850465,6851262,545,6851807
1008,50,50,6858989,6859805,833,6857291,6858076,907,6858983
1009,14,14,6865782,6865998,233,6864100,6864890,885,6865775
1010,44,44,6872575,6873290,732,6870910,6871704,865,6872569
1011,36,36,6879434,6880017,599,6877719,6878518,910,6879428
1012,24,24,6886310,6886693,399,6884545,6885332,972,6886304
1013,22,22,6892703,6893052,366,6891354,6892146,550,6892696
1014,58,58,6899812,6900761,965,6898164,6898960,846,6899806
1015,2,2,6906321,6906338,34,6904989,6905774,540,6906314
1016,6,6,6913397,6913480,100,6911799,6912588,803,6913391
1017,4,4,6920040,6920090,66,6918608,6919402,631,6920033
1018,16,16,6926816,6927066,266,6925417,6926216,593,6926809
1019,22,22,6933559,6933908,366,6932243,6933030,522,6933552
1020,54,54,6940468,6941350,899,6939053,6939844,618,6940462
1021,58,58,6947260,6948209,966,6945862,6946658,596,6947254
1022,4,4,6954369,6954419,67,6952688,6953472,891,6954363
1023,30,30,6960846,6961328,499,6959497,6960286,553,6960839
1024,56,56,6968088,6969003,932,6966306,6967100,981,6968081
1025,38,38,6974514,6975130,633,6973116,6973914,594,6974508
1026,38,38,6981273,6981889,633,6979942,6980728,539,6981267
1027,40,40,6988266,6988915,666,6986751,6987542,718,6988260
1028,52,52,6995275,6996124,866,6993560,6994356,913,6995269
1029,12,12,7002151,7002334,200,7000386,7001170,975,7002145
1030,54,54,7008794,7009676,899,7007195,7007984,803,7008787
1031,30,30,7015736,7016219,500,7014005,7014798,932,7015730
1032,6,6,7022495,7022579,100,7020814,7021612,877,7022489
1033,38,38,7029371,7029987,633,7027640,7028426,939,7029365
1034,24,24,7035948,7036330,399,7034449,7035240,701,7035941
1035,20,20,7042757,7043073,333,7041258,7042054,696,7042750
1036,52,52,7049583,7050432,865,7048084,7048868,708,7049576
1037,2,2,7056592,7056608,33,7054894,7055682,904,7056586
1038,22,22,7063251,7063601,367,7061703,7062496,749,7063245
1039,2,2,7070277,7070294,33,7068512,7069310,961,7070271
1040,44,44,7076803,7077519,733,7075338,7076124,673,7076797
1041,52,52,7083629,7084478,866,7082147,7082938,684,7083622
1042,50,50,7090438,7091254,833,7088957,7089752,680,7090432
1043,36,36,7097331,7097914,599,7095783,7096566,759,7097325
1044,52,52,7104207,7105056,866,7102592,7103380,821,7104201
1045,2,2,7111049,7111066,34,7109401,7110194,849,7111043
1046,54,54,7117925,7118808,899,7116211,7117008,912,7117920
1047,24,24,7124801,7125184,400,7123036,7123822,973,7124795
1048,42,42,7131161,7131844,699,7129846,7130636,519,7131155
1049,56,56,7138386,7139302,933,7136655,7137450,930,7138380
1050,60,60,7144863,7145845,999,7143481,7144264,592,7144856
1051,18,18,7151605,7151889,300,7150290,7151078,521,7151599
1052,10,10,7158798,7158948,166,7157100,7157892,900,7158792
1053,24,24,7165624,7166007,399,7163909,7164706,912,7165618
1054,56,56,7172333,7173249,932,7170735,7171520,807,7172327
1055,22,22,7179026,7179375,366,7177544,7178334,685,7179019
1056,10,10,7185852,7186002,166,7184353,7185148,697,7185845
1057,38,38,7192911,7193527,632,7191179,7191962,942,7192904
1058,48,48,7199304,7200086,799,7197989,7198776,522,7199298
1059,4,4,7206413,7206463,66,7204798,7205590,817,7206407
1060,48,48,7213239,7214021,799,7211607,7212404,828,7213232
1061,10,10,7219915,7220065,166,7218433,7219218,690,7219908
1062,4,4,7226891,7226940,66,7225242,7226032,852,7226884
1063,22,22,7233583,7233933,367,7232052,7232846,731,7233577
1064,6,6,7240476,7240559,100,7238878,7239660,810,7240470
1065,44,44,7247335,7248051,733,7245687,7246474,855,7247329
1066,34,34,7253978,7254527,566,7252496,7253288,683,7253971
1067,56,56,7260820,7261736,933,7259305,7260102,712,7260814
1068,16,16,7267713,7267963,266,7266131,7266916,790,7267706
1069,36,36,7274389,7274972,599,7272941,7273730,653,7274383
1070,8,8,7281298,7281415,133,7279750,7280544,748,7281292
1071,60,60,7288091,7289073,999,7286559,7287358,726,7288084
1072,24,24,7294900,7295283,400,7293385,7294172,722,7294894
1073,20,20,7301610,7301926,333,7300194,7300986,617,7301603
1074,2,2,7308386,7308402,33,7307004,7307800,579,7308379
1075,34,34,7315461,7316011,566,7313830,7314614,841,7315455
1076,4,4,7322270,7322320,67,7320639,7321428,836,7322264
1077,16,16,7329130,7329379,266,7327448,7328242,881,7329123
1078,48,48,7336039,7336821,799,7334258,7335056,977,7336033
1079,60,60,7342432,7343414,999,7341083,7341870,555,7342425
